USETH	Y UW S IH TH
D'HONNEUR	D AH N ER
ASHERILL	AE SH ER AH L
WAGONFUL	W AE G AH N F AH L
DAMPISH	D AE M P IH SH
LIMERICKS  L IH M ER IH K S
INFILTRATION  IH N F IH L T R EY SH AH N
PATRIE  P AE T ER IY
BILLIARDS  B IH L Y ER D Z
ADHEMAR	AE D HH IY M AA R
SUMNERS  S AH M N ER Z
ORGIES  AO R JH IY Z
ADELPHI  AH D EH L F IY
TIMANA	T IY M AA N AH
VINER'S	V AY N ER Z
WALTON'S  W AO L T AH N Z
ORD'NARY	AO R D AH N ER IY
BROMPTON'S	B R AA M P T AH N Z
RAPTUROUS  R AE P CH ER AH S
DOMENICHINO	D AA M IH N IH K IY N OW
POTRERO	P AH T R EH R OW
OVERSEERSHIP	OW V ER S IY ER SH IH P
TUE  T UW
SAKE  S EY K
REVITALIZE  R IY V AY T AH L AY Z
BETSEY'S	B EH T S IY Z
RELENTED  R IY L EH N T IH D
MOHACS	M OW HH AE K S
TACKS  T AE K S
PAPILLAE	P AE P IH L EY
FEERED	F IH R D
WAMBLECROPPED	W AA M B AH L K R AA P T
GUNDA	G AH N D AH
THOMAR	TH OW M AA R
ALVEZ'S	AA L V EH Z IH Z
PEREGRINATIONS	P EH R AH G R IY N AE SH AH N Z
POLLENTIA	P AA L AH N T IY AH
TEOTUCTLI	T IY OW T AH K T L IY
MUKLUKS	M AH K L AH K S
URFEIST	ER F AY S T
ILLAKA	IH L AA K AH
SPOONER'S	S P UW N ER Z
INSULATORS  IH N S AH L EY T ER Z
WILTSHIRES	W IH L CH AY R Z
SLANTS	S L AE N T S
EVERYSING	EH V R IY S IH NG
CEYZERIAT	S IH Z EH R IY AH T
RALEIGH'S  R AO L IY Z
NEVAIRE	N AH V EH R
PARSLEY  P AA R S L IY
SQUABBLE  S K W AA B AH L
TWELVEMONTH	T W EH L V M AH N TH
MORSTAN	M AO R S T AH N
LEONARDSTOWN	L EH N AA R D S T AW N
AIRY'S	EH R IY Z
RETRIMMED	R IY T R IH M D
METROPOLE	M EH T R AH P OW L
I'LE	AY AH L
UNDERWAVES	AH N D ER W EY V Z
DIRECTORSHIP  D AY R EH K T ER SH IH P
ROADSTER'S	R OW D S T ER Z
DISTRESS  D IH S T R EH S
WOODROW'S	W UH D R OW Z
WHAT  HH W AH T
CAPSULE  K AE P S AH L
BIRMAH	B ER M AH
SHRIEKINGLY	SH R IY K IH NG L IY
BIFFO	B IH F OW
WORSTING	W ER S T IH NG
SHORT'S	SH AO R T S
DOLLERS	D AA L ER Z
PLASTRAMENGRO	P L AE S T R AH M EH NG G R OW
PAINTED  P EY N IH D
SLOPIN	S L OW P IH N
EV'NING	EH V AH N IH NG
MOCKERIES	M AA K ER IY Z
SKIDBLADNIR	S K IH D B L AH D N ER
BRAIN'D	B R EY N D
DISRESPECTFULLY	D IH S R IH S P EH K T F AH L IY
DINSHAW'S	D IH N SH AO Z
JAP'S	JH AH P S
METON	M AH T AO N
REBUTTONED	R IH B AH T AH N D
GLORIFICATION  G L AO R IH F IH K EY SH AH N
BODYISM	B AA D IY IH Z AH M
PUR  P ER
VASSILYEV	V AE S IH L IY EH V
DISCRIBED	D IH S K R AY B D
SMOLENSKO	S M AH L EH N S K OW
LASAR	L AH Z AA R
SHARLIE	SH AA R L IY
CURSED  K ER S T
SETLED	S EH T AH L D
ELSTER  EH L S T ER
MELANIE  M EH L AH N IY
RAMESAY	R EY M S EY
RARITAN  R EH R IH T AH N
FEDORITCH	F EH D ER IH CH
VANITY  V AE N IH T IY
ERADICATE  IH R AE D AH K EY T
SQUALLS  S K W AO L Z
STRADIVARI	S T R AE D IH V EH R IY
FOURTHS  F AO R TH S
TINDAL  T IH N D AH L
CARNE'S	K AA R N Z
SAI  EH S EY AY
ZORRY	Z AO R IY
SELVAS	S EY L V AH Z
ILONKA	IH L OW NG K AH
UNDERGRADUATE  AH N D ER G R AE JH AH W AH T
FILES  F AY L Z
MASEFIELD'S	M EY Z F IY L D Z
ALMIGHTY'S	AO L M AY T IY Z
VOTARESS	V OW T AO R IH S
THAT'D  DH AE T IH D
JAULGONNE	JH AO L G AA N
LYONNESSE	L AY AH N EH S
AWAKEN  AH W EY K AH N
LENOCHKA	L EH N AH K K AH
FRIPONNE	F R IH P AH N
CAL'S	K AE L Z
UNREFLECTINGLY	AH N R IH F L EH K T IH NG L IY
DEGENERATIONS	D IH JH EH N ER EY SH AH N Z
FULLERS	F UH L ER Z
BOGGY	B AA G IY
TOSTIG'S	T OW S T IH G Z
CABBIE  K AE B IY
CHAMBERS'S  CH EY M B ER Z IH Z
CHESTERMAN  CH EH S T ER M AH N
WARKENTIN  W AO R K AH N T IH N
ACOUNT	AH K UW N T
CHURNS  CH ER N Z
OLMER	OW L M ER
OLDENBURG  OW L D AH N B ER G
CASE  K EY S
NANTUCKETER	N AE N T AH K IH T ER
FRACTURES  F R AE K CH ER Z
FORGIVABLE  F AO R G IH V AH B AH L
EMBARKING  EH M B AA R K IH NG
JANITRESS	JH AE N IH T R IH S
DANCER'S  D AE N S ER Z
TASSILO	T AA S IY L OW
KERMIS	K ER M IH S
CONSTRUCTIONAL	K AH N S T R AH K SH AH N AH L
BUTSUMA	B UW T S UW M AH
MAVROCORDATOS	M AE V R AH K ER D AA T OW Z
REDSKIN  R EH D S K IH N
CHRISTENED  K R IH S AH N D
PLANTAGENET'S	P L AE N T EY JH EH N AH T S
SAKON	S AE K AH N
QUINQUE	K W IH N K W EH
DELIQUIUM	D EH L IY K W IY AH M
CHOURINEUR	CH AW R IY N ER
URQUHART'S	ER K AA R T S
VELD	V EH L D
REFRESHIN	R IH F R EH SH IH N
ASTONISHER	AH S T AA N IH SH ER
KELVIN  K EH L V AH N
EXPECKIT	EH K S P IH K IH T
MISERERE	M IH Z ER IH R
DUPHOT	D AH P AH T
RIOWAG	R IY OW W AE G
CAMPAGNA	K AE M P EY N Y AH
CONTINGENCIES  K AH N T IH N JH AH N S IY Z
SOYOT	S OY OW
NANNICHETTE	N AA N IY SH EH T
CRYSTALLINE  K R IH S T AH L AY N
PANEGYRICKS	P AE N IH JH IH R IH K S
CLARIONS	K L EH R IY AH N Z
CECI  S EH S IY
INDORE	IH N D ER
TYCHE	T AY CH
HATHORNE'S	HH AA TH AO R N Z
WHEREUNTO	W EH R AH N T OW
ROSIER  R OW Z IY ER
MERRIAGE	M EH R IY IH JH
PEESH	P IY SH
COMPRESSA	K AH M P R EH S AH
SIRDAR	S IH R D AA R
WO'KIN	W OW K IH N
DELATOUR	D EH L AH T UH R
IDEALISMS	AY D IY L IH Z AH M Z
SUSPENSION  S AH S P EH N SH AH N
WOMBO'S	W AA M B OW Z
RIZAL	R IY Z AA L
DREADEST	D R EH D AH S T
PUNISHMENTS  P AH N IH SH M AH N T S
DEBITS	D EH B IH T S
TALLYMAN	T AE L IY M AE N
ULMEN	AH L M EH N
BENUMBS	B IH N AH M Z
UNNOTICING	AH N N OW T IH S IH NG
SWANWHITE	S W AO N W AY T
AUGEAS	AO G IY Z
EVENTUAL  AH V EH N CH UW AH L
TEK  T EH K
EVALUATION  IH V AE L Y UW EY SH AH N
TRENCH  T R EH N CH
KYAKS	K Y AE K S
GAINED  G EY N D
ARROWROOT  EH R OW R UW T
MATIER	M AE T Y ER
TAMIN	T AE M IH N
DONAHUE'S	D AA N AH Y UW Z
BLANDANO	B L AA N D AA N OW
STANSFELD	S T AE N S F EH L D
PEASMARSH	P IY Z M AA R SH
RUDEL  R UW D AH L
SHAVEN  SH EY V AH N
JORAN	JH AO R AH N
DERMOD	D ER M AH D
MASSING  M AE S IH NG
CLASSMAN  K L AE S M AH N
G'ON	JH IY OW IH N
PASQUINADE	P AA S K W IH N EY D
TONIC  T AA N IH K
HOMAN  HH OW M AH N
CHAMELEON  K AH M IY L IY AH N
SHOWMEN	SH OW M AH N
RONALDSAY	R AA N AH L D S EY
MACKLYN	M AE K L IH N
UNPERMITTED	AH N P ER M IH T IH D
DEPOPULATED	D IH P AA P Y AH L EY T IH D
WILLFULNESS	W IH L F AH L N AH S
SASHKA	S AE SH K AH
HONOR'D	AA N ER D
THURSLEY	TH ER S L IY
TRAMPLINGS	T R AE M P L IH NG Z
IMPRUDENTLY  IH M P R UW D AH N T L IY
LUCKIE  L AH K IY
AUFIDIUS	OW F IY D IY AH S
LEGER'S	L EH JH ER Z
BOBBINS	B AA B IH N Z
MARTAINVILLE	M AA R T EY N V IH L
FELLAH	F EH L AH
PALMATED	P AA M EY T IH D
CHATTEL  CH AE T AH L
STILLWELL'S  S T IH L W EH L Z
DISCONCERT  D IH S K AH N S ER T
PIMONI	P AH M OW N IY
PARROT  P EH R AH T
DISTRAUGHT  D IH S T R AO T
HEJ	HH EH JH
CANOIST	K AE N OY S T
TEETER  T IY T ER
REPOUSSE	R EH P UW S
HOMARDS	HH OW M AA R D Z
RAKSHASI	R AE K SH AA S IY
VILLENOIX	V IH L IH N OY
LITTLEPAGE  L IH T AH L P EY JH
D'ORBEC	D AO R B EH K
HECATE	HH EH K EY T
GIROLAMO'S	JH IH R OW L AA M OW Z
COURTEAU  K ER T OW
AGGLOMERATIONS	AH G L AA M ER EY SH AH N Z
DEVILISHNESS	D EH V L IH SH N AH S
CROMBIE  K R AA M B IY
PLEIAD  P L IY AH D
PARNASSUS  P AA R N AE S AH S
BELLINGHAMS	B EH L IH NG HH AE M Z
SPARTANBURG  S P AA R T AH N B ER G
SCHWARZWALD	SH W AO R T S W AO L D
SHUSH	SH AH SH
M'SELF	M S EH L F
ELESEUS	EH L EY Z IY AH S
DEBARS	D AH B AA R Z
ARTIZANS	AA R T AH Z AH N Z
JESTER'S  JH EH S T ER Z
LENDER'S  L EH N D ER Z
EPHRON  EH F R AH N
MAINSTREAM  M EY N S T R IY M
WINDT  W IH N T
BARBOUR'S  B AA R B ER Z
ALTERNATED  AO L T ER N EY T AH D
GRANSON	G R AE N S AH N
HEGEMONY  HH IY JH EH M AH N IY
WIGGLE  W IH G AH L
FAVORS  F EY V ER Z
GRAVELEIGH	G R AE V AH L AH
AGRO  AE G R OW
UNDERSHAW	AH N D ER SH AO
LAWRENCEVILLE  L AO R AH N S V IH L
LOINE	L OY N
CARFRAE	K AA R F R EY
CLINTONS  K L IH N T AH N Z
RAYBONE	R EY B OW N
LIQUEFIES	L IH K W AH F AY Z
CORNAL	K AO R N AH L
KNEECAP  N IY K AE P
FACIAT	F AA S IY AA T
ADVOCATES  AE D V AH K EY T S
INCONSISTENCIES  IH NG K AA N S IH S T EH N S IY Z
TWIGGY  T W IH G IY
CHUMMED	CH AH M D
LUCRETIA  L UW K R IY SH AH
LOYD  L OY D
BARRYMORE  B AE R IY M AO R
STATIONARINESS	S T EY SH AH N EH R IY N AH S
SCRITTO	S K R IH T OW
BLUCHERS	B L AH CH ER Z
EXPLORE  IH K S P L AO R
CHAMPA  K AA M P AH
COISLIN	K OW IH S L IH N
MANDANE	M AE N D EY N
CYNEGION	S IH N IY JH AH N
SESHU	S EH SH UW
PARTINGTON  P AA R T IH NG T AH N
EMERALDS  EH M R AH L D Z
PRECY	P R IY S IY
MONTREUX	M AA N T R UW
SIADOUX	S AY AE D UW
DON'D	D OW N D
INCISION  IH N S IH ZH AH N
JADVYGA	JH AE D V IY G AH
MALET	M AE L IH T
NOVIA  N OW V IY AH
CEIVE	S IY V
DIB	D IH B
OLDEST  OW L D AH S T
ULTRA  AH L T R AH
RATIGNOLLE	R EY SH IY N Y OW L
AMPHORAS	AE M F ER AH Z
ALPAGATAS	AE L P AH G AA T AH Z
UGHS	Y UW Z
CHISELL'D	CH IH Z AH L L D
ZENA  Z IY N AH
KRUTZ  K R AH T S
BIJOU	B IY JH UW
SABAEAN	S AH B IY AH N
CRAYTURES	K R EY CH ER Z
ARLES	AA R L Z
SAKEWAWIN	S EY K W AO IY N
REIGNETH	R IY IH G N IH TH
FUZZO	F AH Z OW
CORROBORATIONS	K ER AA B ER EY SH AH N Z
IQUIQUE	IH K IY K
DISCLOSING  D IH S K L OW Z IH NG
CLELLAN'S	K L EH L AH N Z
UNDERESTIMATES  AH N D ER EH S T IH M EY T S
ENDE  EH N D
SELLARS  S EH L ER Z
SADDLEBANK	S AE D AH L B AE NG K
REMEMBERING  R IY M EH M B R IH NG
SHARERS	SH EH R ER Z
ENCYCLOPAEDIC	IH N S AY K L OW P IY D IH K
HUMFREY  HH AH M F R IY
FERTILE  F ER T AY L
HARPIN  HH AA R P AE N
NEWCOMEN'S	N UW K AH M EH N Z
VALANCOURT	V AE L AH N K AO R T
ENERGY  EH N ER JH IY
PHELLION'S	F EH L Y AH N Z
DREXLEY'S	D R EH K S L IY Z
ROVERO	R OW V EH R OW
HEIFER'S	HH EH F ER Z
BARILLON	B EH R IH L AA N
OHADI	OW HH AA D IY
SOT  S AO T
MIZVY	M AY Z V IY
FIBRED	F AY B ER D
BOLSENA	B OW L S EH N AH
BREAKDOWN  B R EY K D AW N
GIRARDIN  ZH IH R AA R D EH N
DOBEEN	D AA B IY N
COGNIZED	K AH G N AY Z D
CONVOYED	K AA N V OY D
OKHRANA	OW K R AA N AH
MOORKA	M AO R K AH
LUMBERSOME	L AH M B ER S AH M
AD  AE D
SHETLAND  SH EH T L AH N D
FERRETY	F EH R AH T IY
ROTGIER	R AA T G IY ER
OLDPORT	OW L D P AO R T
MURDOCH  M ER D AA K
WAU	W AO
PERSPICUOUSLY	P ER S P IH K Y UW AH S L IY
CHRISTIANISING	K R IH S CH AH N AY Z IH NG
SCHOLARLINESS	S K AA L ER L IY N AH S
BHRIGU	B R IH G UW
CORNICED	K AO R N IH S T
HENRICO	AA N R IY K OW
CAMBOOSE	K AE M B UW S
LEDYARD  L EH D Y ER D
PANTALON	P AE N T AH L AA N
MEYDON	M EY D AH N
CIRCUMVENTION  S ER K AH M V EH N CH AH N
BUMBLEBEE'S	B AH M B AH L B IY Z
LUDOVICA	L UW D OW V IH K AH
CRIMINOLOGIST  K R IH M IH N AA L AH JH IH S T
MARVELLOUS	M AA R V EH L AH S
SHARNAK	SH AA R N AH K
FRUIT  F R UW T
STEERERS	S T IH R ER Z
NICCOLINI	N IH K AH L IY N IY
KNECHTS	N EH K T S
SQUAB	S K W AA
GROCHOWSKI  G R AH CH AO F S K IY
ENNA'S	EH N AH Z
NEVEH	N AH V AH
MUMPSON'S	M AH M P S AH N Z
APPANAGES	AE P AH N IH JH IH Z
OBSESSED  AH B S EH S T
WHITED  W AY T IH D
UNPACIFIED	AH N P AE S AH F AY D
MORSFIELD	M AO R S F IY L D
UNEATH	AH N IY TH
LEASEHOLDERS	L IY S HH OW L D ER Z
O'ROURKE  OW R AO R K
CHEATIN	CH IY T IH N
CULBRETT	K AH L B R IH T
GEROLDSTEIN	G EH R OW L D S T AY N
BEATETH	B IY T AH TH
BLOWITT	B L OW IH T
ESIR	IH S IH R
REMAKES  R IY M EY K S
ARGENTIFEROUS	AA R JH AH N T IH F ER AH S
BILLETS  B IH L AH T S
STEENKIRK	S T IY N K ER K
JESSOP'S	JH EH S AH P S
INFURIATED  IH N F Y UH R IY EY T AH D
COONSKIN	K UW N S K IH N
LIZ'S  L IH Z AH Z
FITCHETT  F IH CH IH T
THROPP'S	TH R AA P S
CHINATOWN  CH AY N AH T AW N
ROMOLA  R AA M AH L AH
HELMSMAN  HH EH L M Z M AE N
KADIN	K EY D IH N
TALLY'S	T AE L IY Z
BARTHROP	B AA R TH R AH P
ANGLICISATION	AE NG L IH S AY Z EY SH AH N
POZENDINE	P AA Z EH N D IY N IY
PATELEY	P AE T IH L IY
OUTSTRIPS  AW T S T R IH P S
MENTEITH'S	M EY N T IY TH S
CREEPED	K R IY P T
QUINQUINAMBO	K W IH N K W AH N AA M B OW
UNBEKNOWNST  AH N B IY N OW N S T
PURVIDED	P ER V AY D IH D
LASSELLES	L AE S AH L Z
OBT	AH B T
WHALEY'S	W EY L IY Z
KINGSLAND  K IH NG Z L AE N D
DUGMORE	D AH G M AO R
DUPRE'S	D AH P R EY Z
DRAMATURGY  D R AA M AH T ER JH IY
PIZZ	P IH Z
EBLIS	EH B L IH S
KINGLAKE	K IH NG L EY K
MSUNGU	M S AH NG UW
BIAUCAIRE	B IY AA K EH R
CATOCTIN	K AH T AO K T AH N
ARMENONVILLE	AA R M IY N AA N V IH L
ELOHE	IH L OW
AMELIE	AH M IY L IY
BOLIVICK	B AA L AH V IH K
CHUCKSTER	CH AH K S T ER
LOUDSPEAKERS  L AW D S P IY K ER Z
PUNCHINELLO	P AH N CH IH N EH L OW
MURANO  M UH R AA N OW
RAHNSTADT	R AA N S T AE T
EYELET  AY L AH T
SABELLIANISM	S AH B EH L IY AH N IH Z AH M
TODDLING  T AA D L IH NG
LEMMI	L EH M IY
LAUSUS	L AO S AH S
ACHMET	AA HH M EH T
MANGES  M EY N JH IH Z
PELLERY	P EH L ER IY
BESSACRE	B EH S AH K ER
STANNARY	S T AE N ER IY
REMEDIABLE	R IY M IY D IY AH B AH L
BRIBED  B R AY B D
ADORN'D	AH D AO R N D
IMPUTING	IH M P Y UW T IH NG
WHIMPERINGS	HH W IH M P ER IH NG Z
FOREHEAD'S	F AO R HH EH D Z
MISCARRIAGE  M IH S K EH R AH JH
INVESTITURE  IH N V EH S T AH CH ER
CITRATE	S IH T R EY T
RAMAR	R AH M AA R
COMMERSES	K AH M ER S IH Z
REFUSIN	R IH F Y UW Z IH N
PARTIKLAR	P AA R T IH K L AA R
GRANDES	G R AE N D EH S
UNWONTEDLY	AH N W AA N T IH D L IY
GULS	G UW L Z
OSRA'S	AA Z R AH Z
HYLAS	HH IH L AH Z
SHE'D  SH IY D
CURRENTLY  K ER AH N T L IY
ORRY'S	AO R IY Z
HUASCAR	HH W AE S K ER
CAPPOQUIN	K AE P OW K W IY N
DONEGAL	D AA N IH G AH L
APOSTOLI	AH P AO S T OW L IY
MUENSTERBERG	M Y UW N S T ER B ER G
CZARTORYSKI  S AA R T AO R IY S K IY
TIRELY	T AY ER L IY
WEDLOCK'S	W EH D L AA K S
BURN'D	B ER N D
CLACKETY	K L AE K AH T IY
RANCOROUSLY	R AE NG K ER AH S L IY
TAVERNERS	T AE V ER N ER Z
HOLGRAVE	HH OW L G R EY V
TARATA	T AA R AA T AH
CORRI	K AO R IY
HOMEBURG	HH OW M B ER G
HADJ	HH AE JH
TRIVIA  T R IH V IY AH
REVERSING  R IH V ER S IH NG
GUJARATI	G Y UW JH ER AA T IY
WAINOLA	W EY N OW L AH
AVENIR	AE V AH N IH R
COLOMBAN	K AH L AH M B AE N
WAK'D	W AE K D
BISTOURY	B IH S T UH R IY
FREERE	F R IY R
ERMITA	ER M IY T AH
RAMAGE  R AE M IH JH
MAYDS	M EY D Z
BEZRODNOFF	B EH Z R OW D N AO F
BLOMBERG  B L AA M B ER G
KIU	K IY UW
WAYBILL	W EY B IH L
FORGIVED	F ER G IH V D
PITEOUS	P IH T IY AH S
POPULARLY  P AA P Y AH L ER L IY
SCHWARMER	SH W AO R M ER
ROYALTY  R OY AH L T IY
TURDETANI	T ER D IH T AA N IY
BOXTEL	B AA K S T EH L
PLURALITY  P L ER AE L IH T IY
POSTLETHWAITE'S	P OW S T AH L TH W EY T S
SLICES  S L AY S AH Z
THEOS	TH IY OW Z
DISDAIN'D	D IH S D EY N D
ORCHARDSON	AO R CH ER D S AH N
ELVERSTON	EH L V ER S T AH N
SHAWANGUNK	SH AH W AO NG AH NG K
KNOWTH	N OW TH
SEATTLE'S  S IY AE T AH L Z
POMPIERS	P AA M P IY ER Z
ZANDT  Z AE N T
EIGHT'S  EY T S
UVALDE	Y UW V AH L D
KAISER  K AY Z ER
ARITHMETIC  EH R IH TH M EH T IH K
LAPROBE	L AH P R OW B
FEVRE	F EY V ER
DIVERTING  D AY V ER T IH NG
ENRICH'D	EH N R IH CH D
BELLAY	B EH L EY
POORHOUSES	P UW R HH AW S IH Z
HIKES  HH AY K S
SAYA'S	S AY AH Z
STALDEN	S T AO L D AH N
FREMONA	F R EH M OW N AH
WATERWHEELS	W AO T ER W IY L Z
CLODAGH	K L AA D AH G
GEPIDAE	G EH P IH D EY
WAPSHOTT	W AO P SH AH T
CONVANIENT	K AA N V AH N IY AH N T
SHOPKEEPER  SH AA P K IY P ER
CHEARFULNESS	CH IH R F AH L N AH S
CONGENITAL  K AH N JH EH N AH T AH L
RECLINING  R IY K L AY N IH NG
NISQUALLY	N IH S K AH L IY
MAUMA	M AO M AH
CHEVERNY'S	CH EH V ER N IY Z
PENTATHLON  P EH N T AE TH L AH N
KOMATIPOORT	K OW M AA T IH P UH R T
SUFFOCATION  S AH F AH K EY SH AH N
BARMBY	B AA R M B IY
DOULEBOV	D AW L B AA V
WALLPAPER  W AO L P EY P ER
ROC  R AA K
EXCELLENCY'S	EH K S L EH N S IY Z
PIM	P IH M
JOSEY'S	JH OW Z IY Z
FOISTED  F OY S T IH D
BRACHE	B R EY K IY
COARSENED	K AO R S N D
FALSTAFF  F AO L S T AE F
TILLOU	T IH L UW
TAMERLANE'S	T AA M EH R L EY N Z
YACHTSMEN	Y AA T S M IH N
FARISH  F EH R IH SH
TROON  T R UW N
GILETTI	G IH L EH T IY
COOMBE'S	K UW M B Z
NEOTS	N IY AA T S
FLUELLEN	F L UH L AH N
OZAKI  OW Z AA K IY
VERIFIABLE  V EH R AH F AY AH B AH L
LASCARO	L AA S K AA R OW
SHATTUC	SH AE T AH K
HAECKEL	HH EH K AH L
D'YUH	D IY Y UW
COLFAX	K OW L F AE K S
BASKA	B AE S K AH
ERZINGAN	ER Z IY NG G AH N
WOODWORKING  W UH D W ER K IH NG
NOCTEM	N AA K T EH M
DAMTIDAM	D AE M T AY D AH M
FORSTER'S	F AO R S T ER Z
AGITATE  AE JH AH T EY T
DUCADOS	D UW K AA D OW Z
IVINS  IH V IH N Z
SWINGS  S W IH NG Z
PILEATED	P IH L IY EY T IH D
VOLOGDA	V AA L AH G D AH
PHYLEUS	F AY L IY AH S
CAPISTRANO  K AE P IH S T R AA N OW
MISCARRY	M IH S K EH R IY
LONGICORN	L AO NG IH K AO R N
ENFORD	EH N F ER D
NIBLICK	N IH B L IH K
PRESTONPANS	P R EH S T OW N P AE N Z
TIMUR'S	T IH M ER Z
FINES  F AY N Z
PIGS  P IH G Z
WARES  W EH R Z
LANINGS	L EY N IH NG Z
TASK  T AE S K
SCROUGE	S K R AW JH
ROCKVILLE  R AA K V IH L
SWADDLINGS	S W AA D AH L IH NG Z
FRANKY	F R AE NG K IY
VISUALIZATION  V IH ZH W AH L AH Z EY SH AH N
MYNDE	M IH N D
LIONNETTE	L AY AH N EH T
NANTEUIL	N AE N T UW L
USURPERS	Y UW S ER P ER Z
WEHLE  W EH L IY
CAER	K EY R
GARDENS  G AA R D AH N Z
COMFORMABLE	K AH M F ER M EY B AH L
PIEBALDS	P AY B AO L D Z
SHYED	SH AY D
ESMONDS	EH Z M AH N D Z
HORNG	HH AO R N G
PREPENSE	P R IY P EH N S
PRESSURE'S  P R EH SH ER Z
HADITH	HH EY D IH TH
PROVING  P R UW V IH NG
SLATTED	S L AE T AH D
PERLES	P ER L Z
FELLAH'S	F EH L AH Z
HORI  HH AO R IY
HARRIGAN  HH EH R IH G AH N
UNLEARN'D	AH N L EH R N D
ASSAULTER	AH S AO L T ER
VIHODAR	V IH HH AH D AA R
TSCHUDI	CH UW D IY
COMENIUS	K OW M EH N IY IH S
DEBAUCHE  D EH B AW K
CURSORILY	K ER S ER AH L IY
VIGER  V IH G ER
DISINTERESTED  D IH S IH N T R IH S T IH D
PASSIVELY  P AE S IH V L IY
INTERSTITIAL	IH N T ER S T IH SH AH L
KITTIE	K IH T IY
GOODHUMOURED	G UH D HH Y UW M ER D
CONCEIVETH	K AH N S IY V TH
BEHEADS	B IH HH EH D Z
DEITZ  D IY T S
TUSH  T UH SH
POUR'D	P AW ER D
CHARGEBOEUF	CH AA R JH AH B AH F
ARETHUSA	ER IY TH UW S AH
THANK  TH AE NG K
SCORCHERS	S K AO R CH ER Z
LETTERBLAIR	L EH T ER B L EH R
HEWED	HH Y UW D
WHORL  HH W AO R L
HANBURY  HH AE N B EH R IY
ALDERSHOT	AO L D ER SH AA T
CONTRIBUTOR  K AH N T R IH B Y AH T ER
PINAFORE	P IH N AH F AO R
DELAREY	D IH L AE R IY
SALESBURY	S EY L Z B EH R IY
SUBLIMELY	S AH B L AY M L IY
GENTEELNESS	JH EH N T IY L N AH S
PORTMAN'S	P AO R T M AH N Z
LIPAN	L IY P AA N
LIR	L IH R
SUPPLICATE	S AH P L AH K EY T
SENSU	S EH N S UW
HEIMA	HH AY M AH
HARRIDANS	HH EH R IH D AH N Z
PACTOLIAN	P AE K T OW L IY AH N
BIO  B AY OW
BRAHMINISM	B R AA M IH N IH Z AH M
WINDSAILS	W IH N D Z EY L Z
ROMAGNA	R OW M AE G N AH
SQUALOUR	S K W AA L ER
LONEY  L OW N IY
DILLENBECK  D IH L AH N B EH K
CONVERT'S	K AA N V ER T S
HALLWAYS  HH AO L W EY Z
MASONIC  M AH S AA N IH K
UNLOOSENED	AH N L UW S AH N D
BROBDIGNAG	B R AO B D IH G N AE G
UNANALYZED	Y UW N AE N AH L AY Z D
RHOMBOIDAL	R OW M B OY D AH L
ANERLY	AE N ER L IY
BEZZLE	B EH Z AH L
WHISKERS  W IH S K ER Z
FULL  F UH L
AARONS  EH R AH N Z
MIRON  M IH R AO N
VIRGEN  V ER JH AH N
GILEAD  G IH L IY D
LAADY	L AA D IY
KARAKORUM	K AA R AH K AO R AH M
PALMERIN	P AA L M EH R IH N
VICOLO	V IH K AH L OW
GRATIN	G R AE T AH N
COPTIC  K AA P T IH K
SHE'M	SH IY M
ENCHANTED  EH N CH AE N T IH D
TICKUSS	T IH K AH S
LANGMAID	L AE NG M EY D
LURCANIO	L ER K EY N IY OW
OVERFALLS	OW V ER F AO L Z
CROWN'ST	K R AW N S T
FORTUNATES	F AO R CH UW N AH T S
SEQUESTRATED	S IH K W EH S T R EY T IH D
SALUE	S AH L UW
SUPERIOR  S UW P IH R IY ER
HAITI  HH EY T IY
PILGRIMAGE  P IH L G R AH M AH JH
DOOK	D UH K
MILWARD  M IH L W ER D
SNEAKERS  S N IY K ER Z
DIFFUSENESS	D IH F Y UW Z N AH S
AURA  AO R AH
STRESA	S T R EH S AH
DUST'S	D AH S T S
FYTER	F AY T ER
ESTABLISH  IY S T AE B L IH SH
POSO	P OW S OW
DANU	D AA N UW
MOOLAH	M UW L AH
GRANDVILAIN	G R AE N D V IH L EY N
GAGS  G AE G Z
LEPUS	L EH P AH S
SWEATED  S W EH T IH D
MAGAZINE  M AE G AH Z IY N
HALBERSTADT  HH AE L B ER SH T AE T
YEARNETH	Y ER N IH TH
CASTRES	K AE S T ER Z
SNUCK  S N AH K
GLOBE  G L OW B
STREAMERS  S T R IY M ER Z
CRACKNELS	K R AE K N AH L Z
MULVANEY  M AH L V EY N IY
CHAOS  K EY AA S
ONESIME	W AH N S AY M
A'RONY	EY R OW N IY
CASTELLANE	K EY S T IH L EY N
MARSILE	M AA R S IY L
LATTITUDE	L AE T AH T UW D
BUGO	B Y UW G OW
COPIED  K AA P IY D
GONIGAL	G AA N AH G AH L
ATHLETE  AE TH L IY T
ADJUDICATION  AH JH UW D AH K EY SH AH N
CONTROVERTING	K AA N T R OW V ER T IH NG
STUDIEN	S T AH D IY N
AINU	EY N UW
EXTRICATE  EH K S T R AH K EY T
OSWESTRY	AA S W EH S T R IY
EASTOVER  IY S T OW V ER
MARCADET	M AA R K AH D EH T
UNHOLILY	AH N HH AO L AH L IY
REPELLANT	R IH P EH L AH N T
BLUMENFELD  B L UW M IH N F EH L D
ARENENBERG	AA R AH N EH N B ER G
VISITATIONS  V IH Z AH T EY SH AH N Z
JAURES	Y AW R EY Z
CHICOT'S	CH IH K AH T S
EGGLESTONE	EH G AH L S T OW N
CADWALLON	K AE D W AO L AH N
STATEROOM	S T EY T R UW M
MURISON	M Y UH R IH S AH N
WHIMPER  W IH M P ER
MIQUELETS	M IY K L AH T S
SOCINIAN	S OW S IY N IY AH N
MENELAOS	M EH N AH L AW S
OPHELIA'S	AA P IH L Y AH Z
WHITWALL	HH W IH T W AO L
RODBURD	R AA D B ER D
MIMICK	M IH M IH K
CHANTEREINE	CH AE N T ER AY N
AMRAPHEL	AE M R AE F AH L
ANG  AE NG
INCOMPREHENSIBILITIES	IH NG K AA M P R IY HH EH N S AH B IH L AH T IY Z
LIDDIARD	L IH D IY ER D
CZTAN	CH T AH N
OCCASIONALLY  AH K EY ZH AH N AH L IY
METACOMET	M EH T AH K AH M EH T
WINTERPINE	W IH N T ER P IY N
BABUS	B AE B IH S
WEAKISH	W IY K IH SH
SMALE  S M EY L
CHAPULTEPEC	CH AE P AH L T IH P EH K
NOMINI	N OW M IY N IY
COMTESSE	K AA M T EH S
LEAVENING  L EH V AH N IH NG
LECHWE	L EH CH W
SEVENSEE	S EH V AH N S IY
SPANGLED  S P AE NG G AH L D
HARDWICK'S	HH AA R D W IH K S
PASSAGE  P AE S AH JH
POSY	P OW Z IY
DUXBRIDGE	D AH K S B R IH JH
APPENDIX  AH P EH N D IH K S
MAHMOUD  M AE M UW D
GERMAINE  ZH ER M EY N
OLET	OW L AH T
FITTER  F IH T ER
SNEATHY	S N EH TH IY
EPINGLES	IH P IH NG G AH L Z
SHEYKHS	SH EH K S
BRAKEN	B R EY K AH N
TREFFINGER	T R EH F IH NG ER
PAPYRUS	P AE P AY R AH S
FURENS	F Y UH R AH N Z
WOOLWORK	W UH L W ER K
CIRCASSIAN	S ER K AE S ZH IH N
COMPETING  K AH M P IY T IH NG
UNREQUITED  AH N R IY K W AY T IH D
PIERMONT	P IH R M AA N T
SOLILOQUIST	S AH L IH L AH K W IH S T
BIDDIE  B IH D IY
FORTRESSED	F AO R T R AH S T
NOTTINGS	N AA T IH NG Z
SKINLESS  S K IH N L AH S
JOANNE  JH OW AE N
HEMOGLOBIN  HH IY M AH G L OW B AH N
ROSELAER	R OW Z AH L IH R
VALSES	V AE L S IH Z
MAUDGE	M AO JH
SANDBANKS	S AE N D B AE NG K S
PUSAT	P UW S AA T
REFERR'D	R IH F ER D
MYSTICISM  M IH S T IH S IH Z AH M
BEFALLING	B IH F AO L IH NG
SCHILLER'S  SH IH L ER Z
SUDRAS	S AH D R AH S
NARVOUS	N AA R V AH S
CACAO  K AH K EY OW
COUNTERPOISED	K AW N ER P OY Z D
TANZ	T AE N Z
PICTUR'D	P IH K CH ER D
MAGUED	M AH G D
ORINDA  ER IH N D AH
SHIPBUILDER'S	SH IH P B IH L D ER Z
SLAKING	S L EY K IH NG
SECRETS  S IY K R IH T S
SELLON'S	S EH L AH N Z
STORMINGS	S T AO R M IH NG Z
HEREON	HH EH R AO N
AGREEING  AH G R IY IH NG
GORGE'S	G AO R JH IH Z
WEATHER'LL	W EH DH R AH L
WEDGED  W EH JH D
COLLISHAW	K AA L IH SH AO
TOITS	T OY T S
BLOBBER	B L AA B ER
MOBILISATION	M OW B AH L IH Z EY SH AH N
LYTTLETON	L IH T AH L T AH N
PII	P IY
MISNOMERS	M IH S N OW M ER Z
MADELINE'S	M AE D AH L AY N Z
MS  M IH Z
CADGED	K AE JH D
NOMME	N AA M
SIROR	S AY R ER
LUTYENS	L UW T IY EH N Z
HARVESTING  HH AA R V AH S T IH NG
LEGATION	L AH G EY SH AH N
STEEPLECHASER	S T IY P AH L CH EY S ER
DOFF'D	D AO F D
CENSORINUS	S EH N S ER AY N AH S
REPEOPLING	R IY P IY P AH L IH NG
NOISES  N OY Z IH Z
MORPETH	M AO R P IH TH
PLACEMEN	P L EY S M AH N
MATRICIDE	M AE T R AH S AY D
LOISSON	L OY Z S AH N
OBAA	OW B AH
CRUICKSHANK  K R UH K SH AE NG K
RECENSION	R IY S EH N SH AH N
TAES	T EY Z
GOROKO	G AO R OW K OW
SLUTTISH	S L AH T IH SH
LOOLOO	L UW L UW
SWE	S W IY
CHINAMPA	CH AY N AE M P AH
YARRO	Y AA R OW
SEQUESTER  S IH K W EH S T ER
GASPON	G AA S P AH N
ABENDBLATT	AE B EH N D B L AH T
TRAVEL'S	T R AE V AH L Z
SAFEGUARDS  S EY F G AA R D Z
ZABRISKIE'S	Z AE B R IH S K IY Z
DOUG'S  D AH G Z
BORDERING  B AO R D ER IH NG
CHIFFONIERS	CH IH F AH N IY ER Z
BONG  B AA NG
OVUM  OW V AH M
PROWLER  P R AW L ER
COEURS	K ER Z
NEANDERTHAL  N IY AE N D ER TH AO L
MANET  M AA N EY
BERYL'S	B EH R AH L Z
RIQUIER	R IH K Y ER
MIDFONT	M IH D F AA N T
KROOMEN	K R UW M AH N
BUDGET  B AH JH IH T
MERCIFULLY  M ER S IH F AH L IY
BLATE	B L EY T
KUSAIE	K Y UW S AY
NORTHCOPE	N AO R TH K OW P
FEROE	F EH R OW
FORDHAM'S	F AO R D AH M Z
MONTAGNE  M AH N T EY N Y
LEAUVITE	L EH OW V AY T
BLACKLADIES	B L AE K L AE D IY Z
FURBY  F ER B IY
VANIKORO	V AA N IH K AO R OW
LARUJA	L AA R UW Y AH
CACIQUES	K AH S IY K S
BOYER'S	B OY ER Z
ZERBST	Z ER B S T
ANNUALS  AE N UW AH L Z
TAXIMETER	T AE K S AH M IY T ER
FADE  F EY D
CONFIDINGLY	K AH N F AY D IH NG L IY
CHIMAERA'S	CH IH M EH R AH Z
XENOPHON'S	Z EH N AH F AH N Z
HUMPBACKED	HH AH M P B AE K T
RUYSDALE	R AY Z D EY L
SHOPPING  SH AA P IH NG
LAEMKE	L EY M K IY
PARTICIPATE  P AA R T IH S AH P EY T
KINDERHOOK	K IH N D ER HH UH K
JESTRESS	JH EH S T R IH S
WINANS  W IH N AH N Z
TEREBRATULA	T EH R AH B R AH T UW L AH
CAMARGA	K AA M AA R G AH
BRITISH  B R IH T IH SH
VARDEMAN  V AA R D M AH N
WONDHER	W AA N D HH ER
LOIRE  L OY R
VALMORE	V AE L M AO R
LOIDIES	L OY D IY Z
MELITE	M EH L AY T
CYNIC'S	S IH N IH K S
KOROS	K AO R OW Z
STITCHING  S T IH CH IH NG
IMPORTUNITY	IH M P ER T UW N AH T IY
POITAIN	P OY T AH N
GERMINAL	JH ER M AH N AH L
SUTTERBY	S AH T ER B IY
DICKIE'S	D IH K IY Z
APT  AE P T
ZHA	Z AA
AMALON	AH M AE L AH N
VERAY	V EH R EY
WIGMORE  W IH G M AO R
CAMPANY	K AE M P AH N IY
GROBSTOCK	G R AA B S T AA K
CULTURE  K AH L CH ER
LETTHERS	L EH T DH ER Z
SUNDOWN'S	S AH N D AW N Z
BEMMON'S	B EH M AH N Z
POLZELLI	P OW L Z EH L IY
DISHES  D IH SH IH Z
MONADNOC	M AA N AE D N AA K
ROUNDLY  R AW N D L IY
CARBONATED  K AA R B AH N EY T AH D
ARCHFIEND	AA R CH F IY N D
ENGRAFTED	IH N G R AE F T IH D
PORRIDGES	P AO R AH JH AH Z
PHAEDRIA	F EH D R IY AH
OWL  AW L
MAESTOSO	M AY S T OW S OW
SCRAPPED  S K R AE P T
CANZONETS	K AA N Z OW N EH T S
GOOD'LL	G UH D L
DECATER	D IH K EY T ER
D'AUSTERLITZ	D AO S T ER L IH T S
GRAPHICALLY  G R AE F IH K L IY
RIGHTFUL  R AY T F AH L
VERRY  V EH R IY
PLENARY  P L IY N ER IY
RANADAR	R AE N AH D AA R
KAGEKIYO	K AA G K IY OW
CERAMICS  S ER AE M IH K S
SONOROUSLY	S AA N ER AH S L IY
SEPTS	S EH P T S
TIGLATH	T IH G L AH TH
SACH	S AE CH
MARAI	M AA R AA IY
BABU'S	B AA B UW Z
TOURNAY	T UW R N EY
COYA	K OY AH
PTOLEMY'S	T AA L AH M IY Z
PELLISSON	P EH L IY S AH N
CABBAGE  K AE B IH JH
HOLPEN	HH OW L P EH N
QUESTIONS  K W EH S CH AH N Z
OILAND	OY L AH N D
INCONVERTIBLE	IH N K AH N V ER T AH B AH L
TONGATABU	T AA N G AH T AA B UW
WEBBED  W EH B D
FLOWEST	F L OW AH S T
QUINTA  K W IH N T AH
DEWS  D UW Z
HORUM	HH AO R AH M
REELECTED  R IY IH L EH K T AH D
SINNOTT  S IH N AH T
JILTING	JH IH L T IH NG
HICK  HH IH K
CASTENO	K AA S T EH N OW
SARDINE  S AA R D IY N
ANINE	AH N IY N
UNTRUTHFULNESS	AH N T R UW TH F AH L N AH S
RIKOR	R IH K ER
LENSKY'S	L EH N S K IY Z
BROMWICH  B R AA M W IH CH
THISTLES  TH IH S AH L Z
SANCTIFIES	S AE NG K T AH F AY Z
KABIR	K AH B IH R
STITCHINGS	S T IH CH IH NG Z
BELLOWER	B EH L OW ER
SHRIEKERS	SH R IY K ER Z
BODINE'S	B OW D IY N Z
SWEARIN	S W IH R IH N
SWELTERS  S W EH L T ER Z
LUFFS	L AH F S
THROATED  TH R OW T IH D
EVADES  IH V EY D Z
CABE  K EY B
BADLY  B AE D L IY
FORCEFULNESS  F AO R S F AH L N AH S
ADONIJAH	AH D AA N AH JH AH
QUESTIONABLY	K W EH S CH AH N AH B L IY
BRAESIG'S	B R EH S IH G Z
SYLVANE	S IH L V EY N
CUMBER'S	K AH M B ER Z
HAPPENETH	HH AE P AH N EH TH
LETHARGICALLY	L EH TH ER JH IH K L IY
KOK'	K AH K
CONNECTICUT  K AH N EH T AH K AH T
RYAN  R AY AH N
ANNOUNCEMENT  AH N AW N S M EH N T
PLAGUEY	P L EY G EY
GNATONG	N AE T AO NG
HAMAKO	HH AE M AH K OW
UNTHANKED	AH N TH AE NG K T
DEMIGODS	D IY M IH G AH D Z
CHARTRIEN	CH AA R T R IY AH N
JOAB	JH OW AE B
BILLINA	B IH L IH N AH
CLAIRMONT  K L EH R M AH N T
SETA	S EH T AH
TRESLER	T R EH S L ER
INTERCONNECTION  IH N T ER K AH N EH K SH AH N
UNCHARTED  AH N CH AA R T IH D
GROWLER'S	G R AW L ER Z
SOMEWHEERS	S AH M W IH R Z
BEECROFT  B IY K R AO F T
MARKS'S  M AA R K S IH Z
BELLEVITE	B EH L AH V AY T
FURNACE  F ER N AH S
VERDURIN	V ER D UH R IH N
BRIERY	B R IH R IY
MORALITY  M ER AE L AH T IY
CAREY'S  K EH R IY Z
LUDWIG  L AH D W IH G
PLAINT	P L EY N T
LAMENTIN	L AH M EH N T IH N
SCATCHARD	S K AE CH ER D
SNEAKINGLY	S N IY K IH NG L IY
BAISER	B EY Z ER
LIEUTENANTS  L UW T EH N AH N T S
ZAIDIE'S	Z EY D IY Z
BADEAU  B AH D OW
JACOBO  Y AA K OW B OW
DERBY'S	D ER B IY Z
GODWINIAN	G AA D W IH N IY AH N
MOZZARELLA	M OW T S AA R EH L AH
TIM'D	T IH M D
MISERLINESS	M AY Z ER L IY N AH S
GOLDSTUECKER	G OW L D S T UW K ER
NEO  N IY OW
RAMBLED  R AE M B AH L D
CHENG  CH EH NG
YAGOUBE	Y AH G UW B
WUDS	W AH D Z
CIVILISERS	S IH V AH L AY Z ER Z
RABUTIN	R AE B AH T IH N
ROLLE'S	R OW L Z
SCHACABAC	SH AE K AH B AE K
SPELL'S	S P EH L Z
SUNCHILDISM	S AH N CH AY L D IH Z AH M
SINNETT'S	S IH N AH T S
SLOOT	S L UW T
OTTMAR'S	AA T M ER Z
CULTURE'S  K AH L CH ER Z
GIUSTI'S	JH UW S T IY Z
RADIATED  R EY D IY EY T AH D
SKRATDJ	S K R AE T JH
KENDAL'S	K EH N D AH L Z
MIRCALLA	M ER K AE L AH
KOTE  K OW T
DORRICOT	D AO R AH K AA T
TUPPENCE	T AH P IH N S
ATTEND  AH T EH N D
GASKET  G AE S K AH T
CROOD	K R UW D
KHATUSARU	K AA T UW S AA R UW
IDEALIZE  AY D IY L AY Z
O'DONOGHOE'S	OW D AA N AH HH OW Z
PUGGAREE	P AH G ER IY
FOOTBOARD	F UH T B AO R D
BENNINGTON'S	B EH N IH NG T AH N Z
TANRADE'S	T AE N R EY D Z
BLAKEFORD	B L EY K F AO R D
STEM  S T EH M
DAMPIER  D AE M P IY ER
BERNINI	B ER N IY N IY
APPIN	AH P AE N
MARRY  M EH R IY
HULLED  HH AH L D
CHAMPIGNONS	SH AE M P IH G N AH N Z
ANOINTED  AH N OY N T AH D
MANURING	M AH N UH R IH NG
PHAT	F AE T
ATMOSPHERICAL	AE T M AH S F EH R IH K AH L
SPENCER  S P EH N S ER
EILIE	AY L IY
NIHILISM  N AY AH L IH Z AH M
ODDS  AA D Z
COYEST	K OY IH S T
BLETHER	B L EH TH ER
LUMINOSITY	L UW M IH N OW S IH T IY
SINQUEFIELD  S IH N K W IH F IY L D
SUPREMACY  S AH P R EH M AH S IY
MONTENEGRO  M AA N T AH N EY G R OW
RONE'S	R OW N Z
ARID  EH R AH D
TRUDGEON	T R AH JH AH N
MILLSBURGH	M IH L Z B ER G
ABDICATED  AE B D AH K EY T AH D
TELEPHONY  T EH L AH F OW N IY
PUTTA	P AH T AH
THURIO	TH UH R IY OW
COUE'S	K UW Z
INDORSE	IH N D AO R S
AGITATED  AE JH AH T EY T AH D
NUMBER'D	N AH M ER D
BLUEPRINT  B L UW P R IH N T
DESPOIL'D	D EH S P OY L D
ACHIEVERS  AH CH IY V ER Z
CHECKERWORK	CH EH K ER W ER K
ATE  EY T
PEDROTTI  P EH D R OW T IY
ORDINARIE	AO R D AH N EH R IY
FERRARD	F ER AA R D
XV'S	Z F S
RAVEL  R AH V EH L
UNSHACKLED  AH N SH AE K AH L D
ILSE'S	IH L S IH Z
ERNIE  ER N IY
ARDEA	AA R D IY AH
LALUSINI'S	L AA L UW Z IY N IY Z
LIVINGSTON  L IH V IH NG S T AH N
IGNATIA  IH G N AA SH AH
OBLIGINGNESS	AH B L AY JH IH NG N IH S
NAPERY	N EY P ER IY
NOVI  N OW V IY
MYSTERY  M IH S T ER IY
GENSONNE	JH EH N S AH N
TRUSSED	T R AH S T
TOPCOAT	T AA P K OW T
SALESA	S AH L EH S AH
REPUBLIC'S  R IY P AH B L IH K S
SAHAI	S AE HH AY
FLOWERDEW	F L AW ER D UW
FIELDS'S	F IY L D Z IH Z
AUSTERER	AO S T IH R ER
JONKVANK	JH AA NG K V AH NG K
TWOMBLEY	T W AA M B L IY
STOREROOM  S T AO R R UW M
WHARFSIDE	W AO R F S AY D
AESTHETICISM	EH S TH EH T IH S IH Z AH M
BUECHNER  B Y UW K N ER
YEERE	Y IH R
PERFUNCTORILY	P ER F AH NG K T R AH L IY
CORRECTS  K ER EH K T S
GAVITT  G AE V IH T
OSKALOOSA	AA S K AH L UW S AH
KEYBOARD  K IY B AO R D
UNORIGINAL	AH N ER IH JH AH N AH L
TUSCULUM	T AH S K Y AH L AH M
TOSH  T AA SH
ATTIRING	AH T AY R IH NG
SANDAY	S AE N D EY
SWABBING	S W AE B IH NG
SUSIE'S  S UW Z IY Z
LEUCOTHEA	L UW K AA DH IY AH
SZEKELY  SH IY K L IY
CAHN'T	K AA N T
ATLI'S	AE T L IY Z
DORGEROUX'S	D AO R G ER UW Z
VOYNICH	V OY N IH CH
PEARE	P IY R
DERA	D EH R AH
ANNE  AE N
AIA	AY AH
NERVOUS  N ER V AH S
LAON	L EY OW N
FAVIER	F EY V Y ER
CETYWAYO	S IY T IY W EY OW
EFFUSIVELY  IH F Y UW S IH V L IY
SEQUESTRATIONS	S IH K W EH S T R EY SH AH N Z
FORGEMEN	F AO R JH M AH N
COURTECUISSE	K AO R T EH K W IY S
PHOE	F IY
SANTAYANA  S AE N T AY AA N AH
BRIGGERLAND'S	B R IH G ER L AH N D Z
GILFORD  G IH L F ER D
AWFU	AA F
WANSFORD	W AO N Z F ER D
DASMARINAS	D AE Z M ER IY N AH Z
LANYERE	L AA N Y ER
TOTTENHAM  T AA T AH N HH AE M
WERWOLVES	W ER W UH L V Z
MARMOUSTIERS	M AA R M AW S T Y ER Z
STATUETTES  S T AE CH UW EH T S
DOWD'S	D AW D Z
PLEBISCITE  P L EH B AH S AY T
MAHOMMED'S	M EY OW M EH D Z
DJORN	JH ER N
CLERIHEW	K L EH R AH HH Y UW
UNEDIFYING	AH N EH D AH F AY IH NG
UNTRAVELLED	AH N T R AE V AH L D
BADGEWORTHY	B AE JH W ER DH IY
HUMBUGGIN	HH AH M B AH G IH N
MEROVEE	M ER OW V IY
WONDAH	W AA N D AH
MAHABHARAT	M AA HH AA B ER AA T
MAITRESSE	M EY T R AH S
WHITEHORSE  W AY T HH AO R S
AZITO'S	AH Z IY T OW Z
MONTEREY  M AA N T ER EY
HU'T	HH UW T
PERL  P ER L
BRR	B ER
MELANCHOLIA	M EH L AH N K OW L IY AH
ESQR	EH S K Y ER
SPIC  S P IH K
TASSELLED	T AE S AH L D
DESBOROUGH'S	D EH Z B ER OW Z
PHILIPPS  F IH L IH P S
IRONIST	AY R AA N IH S T
SIF'S	S IH F S
MOSLEMIN	M AA Z L AH M IH N
DIREXIA	D ER EH K S IY AH
ARBEIT	AA R B AY T
FIDLER  F AY D AH L ER
ONETH	W AH N EH TH
BEYOND  B IH AO N D
JE  JH IY
JURY'S  JH UH R IY Z
UPRISETH	AH P R AY Z AH TH
CUMBRE	K AH M B ER
RESELL  R IY S EH L
DETRIMENT  D EH T R AH M AH N T
LAKELANDS	L EY K L AH N D Z
FING	F IH NG
THRILLER  TH R IH L ER
STRYCHNOS	S T R IH K N OW S
CONVULSIONNAIRES	K AH N V AH L SH AH N EH R Z
EPHRATAH	IY F R AA T AH
RESISTS  R IY Z IH S
CADIZ  K AH D IY Z
ROODHUIS	R UW D HH UW IH Z
PROCEDURES  P R OW S IY JH ER Z
HORSEWHIPPING	HH AO R S W IH P IH NG
PAPRICA	P AE P R IY K AH
FRESHWATER  F R EH SH W AO T ER
SOMEDAY  S AH M D EY
TOBIAS  T AH B AY AH S
RABBINATE	R AE B AH N EY T
FUERAT	F Y UW R AE T
LATHERY	L AE DH ER IY
CASTLEWELL	K AE S T AH L W EH L
FORWARDS  F AO R W ER D Z
MISTRUSTFUL  M IH S T R AH S T F AH L
WALDON  W AO L D AH N
PARVISE	P AA R V AH S
CHILDUN	CH IH L D AH N
REDLINTIE	R EH D L IH N T IY
SAJIPONA	S AE JH IH P OW N AH
SWATHES	S W EY DH Z
BOISRONDET	B OY S R OW N D EH T
BLUBBERED	B L AH B ER D
PRESENTING  P R IY Z EH N T IH NG
GLEED	G L IY D
MARUJA	M ER UW Y AH
LAHEY'S	L EY HH IY Z
HADNOCK	HH AE D N AH K
COOPS	K UW P S
ENSEMBLE  AA N S AA M B AH L
NO'M	N OW M
ERRINGTON'S	EH R IH NG T AH N Z
UNCOMFORTABLENESS	AH N K AH M F ER T AH B AH L N AH S
APPOYAS	AH P OY AH Z
LOCOED	L OW K OW D
DOWNTON	D AW N T AH N
BLACKEE	B L AE K IY
PHILLIPS  F IH L IH P S
INTERSECTS  IH N T ER S EH K T S
MARTUIN	M AA R T UW AH N
GOMERIL	G OW M EH R IH L
WELFORD'S	W EH L F ER D Z
APPEND  AH P EH N D
CITRINUS	S IH T R IY N AH S
MANDAMUS  M AE N D EY M AH S
ORIENT'S	AO R IY EH N T S
UNTHOUGHTFUL	AH N TH AO T F AH L
THEORBO	TH IY ER B OW
PARADISIACAL	P EH R AH D AY S AY AH K AH L
LYUBICH	L Y UW B IH CH
TAAEKE	T AA AY K
UNROOFED	AH N R UW F T
REPEATING  R IH P IY T IH NG
GAZELLA  G AH Z EH L AH
REPROBATE  R EH P R AO B EY T
WOLLOP	W AA L AH P
DUVIVIER	D UW V AY V IY ER
SARVES	S AA R V Z
PENROOF	P EH N R UW F
PAWNSHOP  P AO N SH AA P
ZULU'S	Z UW L UW Z
TREVNA	T R AH V N AH
MOXEY	M AA K S IY
CREATURE'S	K R IY CH ER Z
RECEIVING  R AH S IY V IH NG
SHAC	SH AE K
FALMOUTH'S	F AE L M AH TH S
UNTING	AH N T IH NG
VINCERE	V IH N S IH R
AVEA	AA V IY AH
MANI  M AA N IY
LOVICK  L AA V IH K
HULLIN	HH AH L IH N
YUKIKO	Y UW K IY K OW
CONCHO	K AA N CH OW
CONTAMINATES  K AH N T AE M AH N EY T S
COMRADE  K AA M R AE D
OBLIGATO	AA B L AH G EY T OW
RIC  R IH K
UNHINGES	AH N HH IH N JH IH Z
MAUKI'S	M AO K IY Z
FITZURSE	F IH T S ER S
UNDESCRIBED	AH N D IH S K R AY B D
ASDINGS	AE S D IH NG Z
KABY	K EY B IY
MIAOULIS	M IY AW AH L IH S
MUTTONS	M AH T AH N Z
SCAMPS	S K AE M P S
CARCANETS	K AA R K AH N EH T S
CONI	K OW N IY
MERIK	M EH R IH K
LECTURES  L EH K CH ER Z
MANIHOT	M AH N IH HH AH T
GRANDPA  G R AE N P AA
CAS  K AE S
TMOLUS	T M OW L AH S
SUDHA	S UW D AH
STUDIE	S T AH D IY
EVOLUTIONARY  IY V OW L UW SH AH N EH R IY
ANNUNCIATA  AA N UW N CH AA T AH
LAMOINE	L AE M OY N
DUNCH	D AH N CH
RECONCILABLE	R IY K AH N S IH L AH B AH L
CERRE	S EH R
APPLEHEAD'S	AE P AH L HH EH D Z
WEENG	W IH NG
TOLLA'S	T OW L AH Z
CONSIDERATIONS  K AH N S IH D ER EY SH AH N Z
FRANCKE  F R AE NG K
SENACHIE	S EH N AA K IY
CARNOUSTIE	K AA R N UW S T IY
ZENANA	Z IY N AE N AH
LAMIAE	L EY M IY AH
DOSIA  D OW S IY AH
ORTEGUILLA	AO R T EY G W IH L AH
JABBIN	JH AE B IH N
STEADBOLT	S T EH D B OW L T
VERRIERES	V EH R Y EH R Z
REEDBUCK	R IY D B AH K
WIGAN	W IH G AH N
OSSA  AA S AH
REOCCUPATION	R IY AA K Y AH P EY SH AH N
JORD	JH AO R D
MIMICKING  M IH M IH K IH NG
ROANNES	R OW AE N Z
ANTON  AE N T AO N
MONSTERS  M AA N S T ER Z
ALEXANDR	AE L IH K S AA N D ER
BAUTTE	B AO T
BULBEN	B AH L B AH N
MIND'	M AY N D
JOYCE'S  JH OY S IH Z
SUNGLASSES  S AH N G L AE S IH Z
ARSENIUS	AA R S IY N IY AH S
LYMINGTON	L IH M IH NG T AH N
GINTLEMEN	G IH N T AH L M IH N
MARECHAUSSEE	M ER EH CH AW S IY
DIFFERING  D IH F ER IH NG
SACQUES	S AE K S
GRAHAME'S	G R AE M Z
MYSORE	M AY S AO R
MEIXNER  M IY K S N ER
DER'S	D ER Z
WURTEMBURG	W ER T AH M B ER G
CAMPAIGNER'S	K AE M P EY N ER Z
BISKAINE	B IH S K EY N
ACCUSINGS	AH K Y UW Z IH NG Z
NAAB'S	N AA B Z
PARTENZA	P AA R T EH N Z AH
SUBMARINES  S AH B M ER IY N Z
SUBMARINES  S AH B M ER IY N Z
INEXORABLY  IH N EH K S ER AH B L IY
ZAMOYSKI	Z AA M OY S K IY
BANTRY	B AE N T R IY
PADDLES  P AE D AH L Z
HALEVI  HH AH L EY V IY
RUMBLES  R AH M B AH L Z
ALTAR  AO L T ER
KEDZIE	K EH D Z IY
GARSTOFF	G AA R S T AO F
BEAKER  B IY K ER
TILLERS	T IH L ER Z
MAIMED  M EY M D
COTTAGES  K AA T IH JH IH Z
ARC  AA R K
WASHSTAND	W AA SH S T AE N D
RECONSTRUCTS	R IY K AH N S T R AH K T S
HEYST	HH EY S T
MATTEO'S	M AA T EY OW Z
WASHTUBS	W AA SH T AH B Z
TRANSFIXING	T R AE N S F IH K S IH NG
SARRAF	S AA R AH F
PODEVIN	P OW D EH V IH N
BROADCASTING  B R AO D K AE S T IH NG
KANDA  K AE N D AH
BOOKKEEPERS  B UH K K IY P ER Z
KHEDIVE	K EY D AY V
METTRIE	M EH T ER IY
FRITILLARIES	F R IH T AH L EH R IY Z
RHODOMONTADE	R OW D AA M AH N T EY D
EVANGELISTS  IH V AE N JH AH L IH S T S
CENSER  S EH N S ER
REGIN	R EH JH AH N
RAVALETTE	R AH V EY L AH T
MAUNDELL	M AO N D AH L
CORRECTIVE  K ER EH K T IH V
THORPEDYKES	TH AO R P D AY K S
PADLOCKED  P AE D L AA K T
MONTES  M AA N T IY Z
PERTENDIN	P ER T EH N D IH N
NIKHIL	N IH K HH IH L
UNDERRUN	AH N D ER R AH N
TIDSWELL	T IH D S W EH L
CHECKERBERRIES	CH EH K ER B EH R IY Z
BIBLICALLY	B IH B L AH K AH L IY
SARATOV  S EH R AH T AO F
PINEAU  P IH N OW
FLATNESS  F L AE T N AH S
VENIA	V IY N IY AH
SIMULATION  S IH M Y AH L EY SH AH N
VEILCHEN	V EY L K AH N
GLUB	G L AH B
BEHRMAN'S	B EH R M AH N Z
MUDGALA	M AH D G AA L AH
DEPOSITOR  D AH P AA Z IH T ER
AIRNED	EH R N D
INTERPETER	IH N T ER P AH T ER
BITUMINOUS  B IH T UW M AH N AH S
HEARTENS	HH AA R T AH N Z
NAUDET	N OW D EH T
CATHERINE  K AE TH ER IH N
STRENGTHENETH	S T R EH NG TH AH N EH TH
CROQUET  K R OW K EY
STARES  S T EH R Z
DISCRIMINATELY	D IH S K R IH M AH N AH T L IY
CATTERALL  K AE T ER AO L
TELEMACHUS	T EH L AH M AA CH AH S
EARTHSIDE	ER TH S AY D
GLUMP	G L AH M P
NOLA  N OW L AH
MAXA'S	M AE K S AH Z
CIPHERING	S AY F ER IH NG
CARTY'S	K AA R T IY Z
GREAVED	G R IY V D
MORYNSKI	M AO R IH N S K IY
BASHA'S	B AE SH AH Z
POKY  P OW K IY
DELUDING  D IH L UW D IH NG
SNEEZE  S N IY Z
STENCILED  S T EH N S IH L D
NETS  N EH T S
CREDITS  K R EH D IH T S
SHANGHAE	SH AE NG HH AY
RAMANUND	R AH M AA N AH N D
LAYNE'S	L EY N Z
COTTAGE  K AA T AH JH
TEUXICAL	T OY K S IH K AH L
CROWNINGSHIELD	K R AW N IH NG SH IY L D
COLUMBUS'S  K AH L AH M B AH S IH Z
POINTY  P OY N T IY
FORSAKES	F AO R S EY K S
DEPRECIATE  D IH P R IY SH IY EY T
SONNINO'S	S AH N IY N OW Z
RAPIDLY  R AE P AH D L IY
RACKLIFF  R AE K L IH F
TORONTO'S  T AO R AA N T OW Z
MILLPOND	M IH L P AH N D
CATHARINA	K AE TH EH R IY N AH
MAWMSEY	M AO M Z IY
PUNDITS  P AH N D IH T S
DOWEY	D AW IY
ALWOOD  AE L W UH D
VERIFYING  V EH R AH F AY IH NG
DOGGESS	D AA G IH S
INTERMEZZO	IH N T ER M EH Z OW
LOAH	L OW AH
LANFEAR  L AE N F ER
MISPRIZED	M IH S P R AY Z D
ASTS	AE S T S
WANCT	W AE NG K T
SAIT	S EY T
DAILINESS	D EY L IY N AH S
PERFEC'LY	P ER F AH K AH L IY
JACKDAWS	JH AE K D AO Z
BLACKMOOR	B L AE K M UH R
PELBY	P EH L B IY
FITZPATRICK'S	F IH T S P AE T R IH K S
THROSTLE	TH R AA S AH L
SAURIN	S AO R IH N
WRANGLING  R AE NG G AH L IH NG
CHAPAREJOS	CH AA P AH R EY Y OW Z
DERAY	D IH R EY
CREAMED  K R IY M D
FACTIONS  F AE K SH AH N Z
STEPHENS  S T EH F AH N Z
GETHING	G EH TH IH NG
KIAKHTA	K AY AH K T AH
BETHIAH	B EH TH AY AH
CABANAL	K AH B AE N AH L
CENTIMES  S EH N T AY M Z
VOUCHING  V AW CH IH NG
KHAMSIN	K AE M Z AH N
BORODAILE'S	B ER OW D EY L Z
SUMACH	S UW M AH K
DOME  D OW M
HEINOUSNESS	HH EY N AH S N AH S
KEARNEY'S  K ER N IY Z
STRAININGLY	S T R EY N IH NG L IY
BOSIO	B OW S IY OW
PORNOGRAPHY  P AO R N AA G R AH F IY
KILGRIS	K IH L G R AH S
HABSBURG  HH AE P S B ER G
CHOIRBOYS	CH OY R B OY Z
SHANTEE	SH AE N T IY
BASILICA  B AH Z IH L AH K AH
OVERLAYS  OW V ER L EY Z
PAPARELLI	P AA P AA R EH L IY
ALOSHA	AH L OW SH AH
SHMAKOVKA	SH M AA K OW V K AH
CENSORIOUS	S EH N S ER AY AH S
SPECIOUS  S P IY SH AH S
EXCELSIOR'S	IH K S EH L S IY ER Z
SUGGESTER	S AH G JH EH S T ER
WHOILE	HH UW AY L
SUCHE	S AH CH
PUMMELED  P AH M AH L D
YOONG	Y UW NG
MILLSTONE  M IH L S T OW N
SLINKED	S L IH NG K T
WREAK  R IY K
FALLED	F AO L D
HOCHSTEIN  HH AA K S T AY N
CAYTA	K EY T AH
VIMYA'D	V AY M IY AH D
AFRUZ	AH F R UW Z
WILMERS	W IH L M ER Z
MAISIE  M EY Z IY
DRUDGERIES	D R AH JH ER IY Z
ADVANTAGES  AE D V AE N IH JH IH Z
ROLD	R OW L D
HONEYWELL  HH AH N IY W EH L
FRIGATE  F R IH G AH T
ACOUSTIC  AH K UW S T IH K
ELAINE'S  IH L EY N Z
PRITHVI  P R IH TH V IY
CLAYBROOK  K L EY B R UH K
ACROSTICS	AH K R AA S T IH K S
WATERPROOFING  W AO T ER P R UW F IH NG
FOCUSING  F OW K IH S IH NG
AQUAFORTIS	AE K W AH F AO R T IH S
VOLS	V OW L Z
RODADERO	R AA D AH D EH R OW
ELSA  EH L S AH
CONTROVERT	K AA N T R OW V ER T
XARAGUA	Z ER AA G W AH
BUCKINGHAMSHIRE	B AH K IH NG HH AE M SH AY R
CRIMINOLOGY  K R IH M IH N AA L AH JH IY
BREUER  B R UW ER
AVOIENT	AA V OW Y AH N T
GRAYSKIN	G R EY S K IH N
HAPENDEKI	HH AE P AH N D EH K IY
SAGEST	S EY JH AH S T
DELETION  D IH L IY SH AH N
PRISCA	P R IH S K AH
SPIEGEL  S P IY G AH L
BEING'S  B IY IH NG Z
PERTURBATION  P ER T ER B EY SH AH N
SHREWDLY  SH R UW D L IY
MILIEU  M IH L Y UH
OSSORY	AA S AO R IY
MOVERS  M UW V ER Z
GIEN	G IY N
SM	S M
UNQUENCHABLE	AH N K W EH N CH AH B AH L
ENDED  EH N D AH D
CURTIUS	K ER T IY IH S
D'HUBERT	D UW B ER T
BROADUS  B R OW D AH S
MACIEK'S	M IH K IY K S
PORTLAND  P AO R T L AH N D
RABIRIUS	R AH B IH R IY IH S
ROGOW	R OW G OW
CHERRIES  CH EH R IY Z
SMUTS	S M AH T S
ERWIN  ER W IH N
GATTY  G AE T IY
LOWBORN  L OW B AO R N
UNIMAGINATIVE  AH N IH M AE JH IH N AH T IH V
SILKIER	S IH L K IY ER
LYUBOMIRSKI	L Y UW B OW M IH R S K IY
PATRONYMICS	P EY T R AH N IH M IH K S
THORVALD'S	TH AO R V AA L D Z
WRYKINIAN	R AY K IH N IY AH N
D'ANTIN	D IY AE N T IH N
OVERFLOWING  OW V ER F L OW IH NG
CARUS	K ER AH S
DIFFERENTIAL  D IH F ER EH N CH AH L
SHERRIFFE	SH EH R IH F
NOTHE	N AH TH
CHAPPARAL	CH AE P ER AE L
ARPINGTON	AA R P IH NG T AH N
ORGANISATION  AO R G AH N IH Z EY SH AH N
BRENTS  B R EH N T S
PROMENADED	P R AA M AH N EY D IH D
PLEBES	P L IY B Z
FOMENTS	F OW M EH N T S
DAWNED  D AO N D
WITCHES  W IH CH IH Z
HINOE	HH IY N OW
INNAMORATA	IH N AH M AO R AA T AH
MALEDETTO	M AE L IH D EH T OW
WHYMAN	W AY M AH N
FENUGREEK  F EH N UW G R IY K
MINGAN	M IH NG G AH N
AKOND	AE K AH N D
GREITIN	G R AY T IH N
VIGOR  V IH G ER
SIRED	S AY ER D
CHAHAZ	CH AE Z
TEBRON'S	T EH B R AH N Z
HEARL  HH ER L
MEDHURSTS	M EH D HH ER S T S
YEER	Y IH R
PETER  P IY T ER
VIRGINIAN'S	V ER JH IH N Y AH N Z
HOMUNCULUS	HH AA M UW NG K Y AH L AH S
ROSEMARY'S	R OW Z M EH R IY Z
ULUA	AH L UW AH
XV	Z V
TOZA	T OW Z AH
TRESSEL  T R EH S AH L
TOUCHINESS	T AH CH IY N AH S
OLLERS	AA L ER Z
WORLDWIDE  W ER L D W AY D
ANDEROON	AE N D ER UW N
GABELLA	G AH B EH L AH
ABHA	AH B HH AH
UKASE  Y UW K EY Z
LECHE	L EH CH
ORCHESTRAL  AO R K EH S T R AH L
ZESTFULLY	Z EH S T F AH L IY
AYLWARD'S	EY L W ER D Z
MADU	M AA D UW
TITTERS	T IH T ER Z
CENTEVILLE	S EH N T AH V IH L
PUREE  P Y UH R EY
BUMPTIOUSNESS	B AH M SH AH S N AH S
MEDORA'S	M EY D AO R AH Z
HOCKLEY  HH AA K L IY
SCOTTI	S K AA T IY
TANSIE	T AE N Z IY
LEWSIDE	L UW S AY D
BEAUPREAU	B OW P R OW
BYRRHENA	B ER IY N AH
LUMBERMAN  L AH M B ER M AH N
ALUMINUM  AH L UW M AH N AH M
OXTON  AA K S T AH N
DROCK	D R AA K
NEAVE  N IY V
PHAKIR'S	F AE K IH R Z
MAHARAJAS	M AA HH ER AA JH AH Z
SINGED  S IH N JH D
MANJA	M AA N Y AH
UNSANCTIONED  AH N S AE NG K SH AH N D
ELLIE  EH L IY
PROVISIONS  P R AH V IH ZH AH N Z
BUILDIN'S	B IH L D IH N Z
PRETIS	P R EH T IH S
TOUGAL	T UW G AH L
MUSHIM	M AH SH IH M
REMANJOU	R IH M AE N JH UW
RANCOROUS  R AE NG K ER AH S
M'MAHON	M M AH HH OW N
OGILVEY'S	OW G AH L V EY Z
CANGIA	K AA N JH AH
AAL	AA L
SECRETE  S IH K R IY T
APATHETICALLY	AE P AH TH EH T IH K L IY
VOUCHSAFED	V AW CH S EY F T
GRUMPINESS	G R AH M P IY N AH S
CHANGEFUL	CH EY N JH F AH L
UNINITIATE	AH N IH N IH SH IY EY T
YOGA  Y OW G AH
NAGS  N AE G Z
POTO	P OW T OW
ROCKER  R AA K ER
REDSHANKS	R EH D SH AE NG K S
DENNEHY'S	D EH N IH HH IY Z
ZINGARELLI	Z IH NG AH R EH L IY
TSA	S AH
L'AUBE	L AO B
SURROUNDIN	S ER AW N D IH N
SINTOBA	S IH N T AH B AH
BRAVADO  B R AH V AA D OW
SHEEPCOTE	SH IY P K OW T
WIGSBY	W IH G Z B IY
POETIZED	P OW AH T AY Z D
SIBUKO	S IH B UW K OW
UNDERHAND	AH N D ER HH AE N D
BARCLAY  B AA R K L EY
MARMS	M AA R M Z
SHEFFIELD'S	SH EH F IY L D Z
SIBYLL'S	S IH B IH L Z
KINGFISHERS  K IH NG F IH SH ER Z
WHISHT	HH W IH SH T
HIGHCOMBE	HH AY K AH M
GUNBELT	G AH N B EH L T
CHAGOS	CH AH G OW Z
CATECHISING	K AE T AH K IH Z IH NG
EMBALMS	EH M B AA M Z
SERVIR	S ER V IH R
BAGGES	B AE G IY Z
DUMS	D AH M Z
NATHLESS	N AE TH L AH S
SARREBOURG	S AE R IH B AO R G
THREAT  TH R EH T
BOULLE	B UW L
MILLENNIUMS  M AH L EH N IY AH M Z
LOGOS  L OW G OW Z
ARIE  EH R IY
LITHUANIAN  L IH TH AH W EY N IY AH N
ERVENG	ER V AH NG
COMANDANTE  K OW M AH N D AA N T EY
SOUSPENNIER	S AW S P EH N IY ER
EXTREMES  EH K S T R IY M Z
COWD	K AW D
TIENTIETNIKOV	T Y EH N SH IY EH T N IH K AA V
KANIKI	K AA N IY K IY
ESTEEME	IH S T IY M
HAIDED	HH EY D IH D
MARESFIELD	M AA R EH S F IY L D
TOMASSO  T OW M AA S OW
PRECOGNITION	P R EH K AH G N IH SH AH N
DINDON	D IH N D AH N
TERRILL  T EH R AH L
PUGSTYLES	P AH G S T AY L Z
BRACKENSHAW	B R AE K AH N SH AO
LONGUEURS	L AO NG ER Z
CHIBOOK	CH IH B UH K
FITZSIMONS  F IH T S IH M AH N Z
FENTRESS  F EH N T R IH S
BIFTEK	B IH F T EH K
PITTORESQUE	P IH T ER AH S K
AULAIRE	AO L EH R
THINKE	TH IH NG K
UPPITY  AH P AH T IY
LATTER  L AE T ER
RUSSY	R AH S IY
TICINO	T IH S IY N OW
ATHELVOK	AH TH IY L V OW K
SULPHURY	S AH L F ER IY
REE'S	R IY Z
FRANKENSTEIN  F R AE NG K AH N S T IY N
GREENWICH  G R IY N W IH CH
GALAFRON	G AE L AH F R AH N
YUM  Y AH M
BINNING  B IH N IH NG
WEAVETH	W IY V IH TH
CLARIDGE'S	K L EH R IH JH AH Z
DONNERWETTER	D AA N ER W EH T ER
PALLIDA	P AA L IY D AH
GALILEANS	G AE L AH L IY AH N Z
SADEN	S EY D AH N
STOOL  S T UW L
CILIX	S IH L IH K S
SCHALISCHIM	SH AE L IH SH IH M
OCKLEBOURNE	OW K AH L B ER N
IMMENSELY  IH M EH N S L IY
FU'S	F UW Z
LOISEAU  L UW AH S OW
ANYT'ING	EH N IY T IH NG
HESELTON  HH IH S EH L T AH N
CONTRIBUTOR'S	K AH N T R IH B Y UW T ER Z
UNCONVENTIONALLY	AH N K AH N V EH N SH N AH L IY
THANKFULLY  TH AE NG K F AH L IY
UNMYSTERIOUS	AH N M IH S T IH R IY AH S
FEIGN'D	F EY N D
CHOUANS	CH UW AH N Z
CAJAH	K AH JH AH
ROKENS	R OW K AH N Z
BOURMONT	B UH R M AA N T
GLEEK	G L IY K
ALLOYING	AH L OY IH NG
SOUHAITE	S UW HH AY T
NOBODY'S  N OW B AA D IY Z
ALTMAN  AO L T M AH N
CONNEWITZ	K AA N IH W IH T S
CHAMOUREAU'S	CH AE M UH R OW Z
DISCOMFORT  D IH S K AH M F ER T
VAUGHANS	V AO AH N Z
VOGT  V OW T
ROYDEN'S	R OY D AH N Z
PIANNER	P IY AE N ER
WALCHEREN	W AO L HH IH R AH N
LITTLEWOODS	L IH T AH L W UH D Z
WEAKNESSE	W IY K N AH S
CHAMOIS	CH AE M W AA
HARMAC	HH AA R M AH K
PAYING  P EY IH NG
SOMEDIMES	S AH M D AY M Z
CLAVICHORD  K L AE V AH K AO R D
DILLER  D IH L ER
APPUI	AH P UW IY
AMEND  AH M EH N D
FARM'S  F AA R M Z
ESMERALDA'S	EH Z M ER R AH L D AH Z
FERRILL  F EH R IY L
SLOB  S L AA B
AGGRESSOR  AH G R EH S ER
DATTO'S	D AA T OW Z
CLOUD  K L AW D
BUBALE	B AH B AA L IY
KEPS	K EH P S
PATRA	P AE T R AH
MERCHANDIZING	M ER CH AH N D AY Z IH NG
RUG  R AH G
SKETCHES  S K EH CH IH Z
SOFT  S AO F T
DICKER  D IH K ER
FA'EN	F AA N
SPERIENCED	S P IH R IY AH N S T
BELAYIN	B IH L EY IH N
TOMASA	T OW M AA S AH
ONSLAUGHTS	AO N S L AO T S
TAMMIS	T AE M IH S
ALACIEL	AA L AA S IY AH L
PUOTE	P W OW T
HEIRLOOMS  EH R L UW M Z
MEMNON  M EH M N AA N
X'S  EH K S IH Z
DENA  D IY N AH
VAURIEN	V AA R IY N
SPAKIN	S P AE K IH N
ASKA  AE S K AH
THORACIC  TH AO R AE S IH K
DEPINE	D IH P IY N IY
DMITRIEVITCH	D M IY T R IY AH V IH CH
FRATERNISED	F R AH T ER N IH S T
VERSANT	V ER S AH N T
PIERO  P IY R OW
LEATHAM  L IY TH AH M
UTTOXETER	AH T AH K S IH T ER
RUMMAGED  R AH M IH JH D
JOACHIM'S  Y OW AA K IH M Z
LIGGINS  L IH G IH N Z
NAZARENES	N AE Z AH R IY N Z
YURTS	Y ER T S
MACHIAVELLI'S  M AA K IY AH V EH L IY Z
TAVANNE	T AA V AA N
VATES	V EY T S
HOHENSTAUFENS	HH OW AH N S T AO F AH N Z
AUTOS  AO T OW Z
APPROVINGLY  AH P R UW V IH NG L IY
SUITES  S W IY T S
WU  W UW
CUTSHAW'S	K AH CH AO Z
PAPIN  P AA P IY N
ACHIN	EY K IH N
DEWDROP	D UW D R AA P
CURDIE'S	K ER D IY Z
PODGORICA	P AA JH AO R IH K AH
MAGEE  M AH G IY
BRACONDALE'S	B R EY K AH N D EY L Z
SHADOW'D	SH AE D OW D
CATAMARAN  K AE T AH M ER AE N
KRANTZ  K R AE N T S
TASTIER  T EY S T IY ER
KIRILIN	K IH R IH L IH N
UNPEELED	AH N P IY L D
CRIPES	K R AY P S
SQ	S K
MERRIED	M EH R IY D
WILEYS	W AY L IY Z
EXPATIATED	EH K S P EY SH IY EY T IH D
BRUBITSCH	B R UW B IH CH
PUFFINGS	P AH F IH NG Z
RENEWER	R IY N UW ER
RONNER	R AA N ER
GLOWWORM	G L AW W ER M
SKIRWOILLA	S K ER W UH IH L AH
SOWSHIP	S OW SH IH P
BREVITY'S	B R EH V AH T IY Z
LAASS	L AA S
RECOUNTAL	R IY K AW N T AH L
LARGE  L AA R JH
IMMEMOR	IH M EH M ER
ARTILLERYMEN	AA R T IH L ER IY M AH N
OSTEOLOGY	AA S T IY AA L AH JH IY
IRMINSUL	ER M IH N S AH L
TRACASSIER	T R EY K AH S IY ER
COSSACK  K AO S AH K
DORIS  D AA R IH S
SALSIFY	S AO L S AH F AY
RIMLESS	R IH M L AH S
ARISTOPHANES  AE R AH S T AO F AH N IY Z
WELZEL	W EH L Z AH L
SEACOLE	S IY K OW L
PORTUGEE	P AO R CH AH G IY
ELOCUTIONISTS	EH L AH K Y UW SH AH N IH S T S
ARI  AA R IY
LEGIONARIES  L IY JH AH N EH R IY Z
ALLATOONA	AE L AH T UW N AH
PLEXIPPUS	P L EH K S IH P AH S
RECUMBENT	R AH K AH M B AH N T
BERTHOALD	B ER TH OW AO L D
SUBJUGATED  S AH B JH AH G EY T IH D
SULLENS  S AH L AH N Z
SUMMERSOFT	S AH M ER S AA F T
AERONAUTICAL  EH R OW N AA T AH K AH L
MOWGLI'S	M OW G L IY Z
BARCLAYS  B AA R K L EY Z
SIMILIBUS	S IH M AH L AH B AH S
LANGWERTH	L AE NG W ER TH
TOISES	T OY Z IH Z
VICK  V IH K
SAYONARA	S EY OW N AA R AH
DYNASTIC  D AY N AE S T IH K
KIPPING	K IH P IH NG
LOVELOCK	L AH V L AA K
VOLUBLY	V AA L Y AH B AH L IY
OBEDIENCES	OW B IY D IY AH N S AH Z
CHYLDE	CH AY L D
HOVEL  HH AH V AH L
DECKLE	D EH K AH L
BOOSEY	B UW S IY
FRE	F R
INFORMIN	IH N F AO R M AH N
FREEMAN  F R IY M AH N
NEREIDS	N IH R IY IH D Z
ROGOJIN	R OW G OW JH IH N
TAREELA	T AA R IY L AH
MOELETTER	M OW L EH T ER
ANTEROOM	AE N T IH R UW M
SHUISKI	SH UW S K IY
ADWAITA	AE D W EY T AH
CUMMINGS'S	K AH M IH NG Z IH Z
ELIHU  EH L IH HH UW
DESPOILED	D EH S P OY L D
ROETTMANN	R OW T M AH N
HARRISBURG  HH EH R IH S B ER G
HEYDUKES	HH EY D UW K S
GAFF'S	G AE F S
DOBRUDJA	D AH B R UW D Y AH
ANTIQUES  AE N T IY K S
BODUOC	B OW D UW AA K
SHALOM  SH AH L OW M
LEADERS  L IY D ER Z
WEHLENBERG	W EH L AH N B ER G
MERGES  M ER JH IH Z
POOTHER	P UW DH ER
CHEFFINGTONS	CH EH F IH NG T AH N Z
VISCERA	V IH S ER AH
FRONT'S  F R AH N T S
FFOLLIOTT	F AH L IY AH T
VINUM	V IH N AH M
HUR'S	HH ER Z
WANTONING	W AA N T AH N IH NG
VOLUNTAS	V AA L AH N T AH S
OVAIRE	OW V EH R
WHITEWATER  W AY T W AO T ER
BEAUFOY	B OW F OY
YOGURT  Y OW G ER T
ANGELA'S  AE N JH AH L AH Z
PATHFINDER'S	P AE TH F AY N D ER Z
PEARLASH	P ER L AE SH
MANILICK	M AH N IH L IH K
PATRICIUS	P AH T R IH SH AH S
LARST	L AA R S T
HORSHAM  HH AO R SH AH M
LILE  L AY L
ANEREW	AH N EH R UW
MAZED	M EY Z D
MIEW	M IY UW
TOPICK	T AA P IH K
SIGLO	S IH G L OW
TROJANS  T R OW JH AH N Z
BARNARDINE	B AA R N AA R D IY N IY
HER'	HH ER
POET  P OW AH T
HERMANA	HH ER M AA N AH
COCOTTE	K OW K AO T
TASAJARA	T AE S AH HH AA R AH
FLA	F L AH
CONDEMN'D	K AH N D EH M D
RICARA	R IH K AA R AH
SILVERTAIL	S IH L V ER T EY L
BIBBIENA	B IH B IY N AH
UNSEASONABLENESS	AH N S IY Z AH N AH B AH L N AH S
MOVELESS	M UW V L AH S
AUMONIER	AW M OW N IY ER
GRUELS	G R UW IH L Z
MURTRY	M ER T R IY
ORDONNANCE	AO R D AA N AH N S
BEEBE  B IY B IY
GHETTO  G EH T OW
PUNKY  P AH NG K IY
PERCY  P ER S IY
ANTIPHUS	AE N T AH F AH S
DRAYCOTT	D R EY K AH T
KUFA	K UW F AH
SINDHIA	S IH N D IY AH
MONKHOOD	M AH NG K HH UH D
BANN  B AE N
BREMMIL	B R EH M IH L
WHITECLETT	HH W AY T K L IH T
PSYCHIST	S AY K IH S T
FRIEDRICH'S	F R IY D R IH K S
HEAV	HH EH V
RECKERMEMBER	R EH K ER M EH M B ER
CONTRITE  K AH N T R AY T
MORTGAGE  M AO R G AH JH
POLIS  P OW L AH S
OILEUS	OY L IY AH S
WHIFFS	HH W IH F S
GUNHILD	G UW N HH IY L D
MERMAN'S	M ER M AH N Z
HANNIBAL'S	HH AE N AH B AH L Z
OBLATE  AA B L EY T
OBLATE  AA B L EY T
CANILLAC	K AH N IH L AH K
SOLITARILY	S AA L AH T EH R AH L IY
AVOIDING  AH V OY D IH NG
ACUSHLA	AE K Y UW S L AH
VENDOR'S  V EH N D ER Z
DARWIN'S	D AA R W IH N Z
BAGGAGES	B AE G IH JH IH Z
EFFECTING  IY F EH K T IH NG
SCAVAIG	S K AH V EY G
ODDITIES  AA D AH T IY Z
BEJAZE	B EY Y AA Z IY
PALINGS	P AE L IH NG Z
CENOBY	S IY N AH B IY
GRATUITOUS  G R AH T UW AH T AH S
SHORT  SH AO R T
BATAVIAN	B AH T EY V IY AH N
KYNNERSLEY	K AY N ER S L IY
SITHED	S AY DH D
WHEELE	W IY L
OVERLIVE	OW V ER L AY V
WEENY  W IY N IY
TOMTITS	T AA M T IH T S
YESTHERDAY	Y EH S DH ER D EY
PENTAGONAL	P EH N T AE G AH N AH L
SIMONY  S AY M AH N IY
BLACKCOCK	B L AE K K AA K
PEACH  P IY CH
COBBLESTONES  K AA B AH L S T OW N Z
MARDIANS	M AA R D IY AH N Z
CLEARWATER  K L IH R W AO T ER
REACTOR  R IY AE K T ER
HEZEKIAH'S	HH EH Z AH K AY AH Z
LITTLES  L IH T AH L Z
APPELLE	AH P EH L
PARADISAIC	P EH R AH D AY S EY IH K
MALUET	M AE L UW T
LEGENDARY  L EH JH AH N D EH R IY
SCHNORR  SH N AO R
GULY'S	G AH L IY Z
ENYHOW	EH N IY HH AW
UNBURTHENING	AH N B ER TH AH N IH NG
PRYTANIA	P R AY T EY N IY AH
VEBLEN	V EH B AH L AH N
HINZA	HH IH N Z AH
LUNETA	L UW N EH T AH
LAZARE'S	L AA Z AA R EY Z
NOBS	N AA B Z
BURKETT  B ER K IH T
BEATER  B IY T ER
PIT'S	P AH T S
IBBOTSONS	IH B AH T S AH N Z
VANDERVELDE'S	V AE N D ER V EH L D Z
HUBSHI	HH AH B SH IY
GATTY'S	G AE T IY Z
CHALDEANS	CH AE L D IY AH N Z
TENNYRATE	T EH N IH R EY T
MANIAS	M EY N IY AH Z
BIDDEST	B IH D AH S T
PARLIAMENT'S  P AA R L AH M AH N T S
LIZZA	L IH Z AH
TAPP  T AE P
OUTNUMBERED  AW T N AH M B ER D
ILEXES	AY L EH K S AH Z
SICKENING  S IH K AH N IH NG
MAXINEFF	M AE K S IY N EH F
ROLUNT	R AA L AH N T
HEFFEROM	HH EH F ER AA M
STAIN'D	S T EY N D
CONJUGALITY	K AA N JH AH G AE L AH T IY
GELSEN	G EH L S AH N
MARAGOUGNIA	M AA R AA G OW G N IY AH
AMES'S  EY M Z IH Z
UNCALCULATED	AH N K AE L K Y AH L EY T IH D
OCHRIDA	OW K ER IY D AH
DENSMORE  D EH N S M AO R
UNSCHOOLED	AH N S K UW L D
DRAMS  D R AE M Z
BRINE  B R AY N
KHATHYL	HH AA TH AH L
SIB  S IH B
SUED  S UW D
AZALEA'S	AH Z EY L Y AH Z
CLAUDET'S	K L AO D EH T S
KEDGEREE	K EH JH ER IY
PONIARDED	P OW N IY AA R D IH D
TURCOS	T ER K OW Z
NORTHMUIR'S	N AO R TH M Y UH R Z
RINNIN	R IH N IH N
LAPSUS	L AE P S AH S
LENS  L EH N Z
GIVNEY'S	G IH V N IY Z
INCOMPATIBILITIES	IH NG K AA M P AH T IH B IH L IH T IY Z
ALCOVES  AE L K OW V Z
PHILLIPSON  F IH L AH P S AH N
TRANSMUTES	T R AE N S M Y UW T S
KNOW'D	N AW D
VICKERY  V IH K ER IY
RIANO	R IY AA N OW
OLFACTORY  OW L F AE K T ER IY
HAZARD  HH AE Z ER D
TRACHEOTOMY	T R EY K IY AH T OW M IY
RICARDI	R IH K AA R D IY
CENSORSHIP  S EH N S ER SH IH P
GALLS  G AO L Z
REVELATOR	R EH V AH L EY T ER
BUCKBOARD	B AH K B AO R D
SOCKED  S AA K T
SOUTHOLD  S AW TH OW L D
VANDERSEE	V AE N D ER S IY
ERKEL	ER K AH L
GENISTA	JH EH N IH S T AH
TOW'RD	T AW R D
WHICHEVER  HH W IH CH EH V ER
STARTERS  S T AA R T ER Z
COVEN  K AH V AH N
SAINFOY	S EY N F OY
ALIANDRA'S	AE L IY AE N D R AH Z
YOCUM  Y OW K AH M
STEBBINS'S	S T EH B IH N Z IH Z
RELINQUISHMENTS	R IY L IH NG K W IH SH M AH N T S
THEWED	TH Y UW D
APPIANI	AE P IY AA N IY
LELY'S	L IY L IY Z
SHAMMED	SH AE M D
FLIM  F L IH M
HAIRCUTTING	HH EH R K AH T IH NG
STEWS  S T UW Z
MIKCHICH	M IH K IH K
ASSASSIN  AH S AE S AH N
TUGGED  T AH G D
COLOMBIANS  K AH L AH M B IY AH N Z
POUPARD  P UW P ER D
KRONISCHE	K R AA N IH SH IY
SWEDISH  S W IY D IH SH
RECOVERING  R AH K AH V ER IH NG
COYNESS	K OY N AH S
VISTUR	V IH S T ER
INGIBJORG	IH NG AH B Y AO R G
WHO'M	HH UW M
ESTERHAZY	EH S T ER HH AA Z IY
CROSSKEY	K R AO S K IY
HEAR  HH IY R
POTCHEFSTROOM	P AA CH EH F S T R UW M
MARKETMAN	M AA R K AH T M AH N
BECHAN	B EH K AH N
WHIRLWINDS	HH W ER L W IH N D Z
EPITOMIZING	IH P IH T AH M AY Z IH NG
WALDENBERG	W AO L D AH N B ER G
LEBANON  L EH B AH N AH N
MISSTATEMENTS  M IH S T EY T M AH N S
UNCLEANSED	AH N K L EH N Z D
KHALIFA'S	K AH L IY F AH Z
PIPMAN	P IH P M AH N
DRAWIN	D R AO IH N
FLORIDA  F L AA R AH D AH
GOSWAMI	G AA S W AA M IY
MERCURIAL  M ER K Y UH R IY AH L
MULCHING  M AH L CH IH NG
CYRIL  S IH R AH L
SUFDER	S AH F D ER
SIPPING  S IH P IH NG
THOROUGH  TH AO R OW
MELLO  M EH L OW
TOIL'S	T OY L Z
HERACLEITUS	HH ER AH K L IY T AH S
WESTOVER'S	W EH S T OW V ER Z
RENNELL	R EH N AH L
STUMBLING  S T AH M B AH L IH NG
EMPLOYD	EH M P L OY D
INCOMPETENT  IH N K AA M P AH T AH N T
DHUNNI	D UW N IY
BOSTONNAIS	B AA S T AH N EY
INAYAT	IH N AY AE T
DERVAL	D IH R V AH L
SLOSHER	S L AA SH ER
NASON  N AE S AH N
BUTTONER	B AH T AH N ER
FRIEDA'S	F R IY D AH Z
JOVEM	JH OW V EH M
BATHERS  B AE DH ER Z
BELFRIED	B EH L F R IY D
MOOD  M UW D
ABERRATIONS  AE B ER EY SH AH N Z
AURIAC	AO R IY AE K
GOTTSCHO	G AA CH OW
EMIGRATES  EH M AH G R EY T S
PHILLIE  F IH L IY
AROUKEEN	ER AW K IY N
FRAMERS  F R EY M ER Z
RICHARDS  R IH CH ER D Z
RANSOME  R AE N S AH M
WUNDERSCHOEN	W AH N D ER SH OW N
LEINSTERS	L AY N S T ER Z
VRILLIERE	V R IY L IY EH R
RIET	R IY T
EMBARRASSINGLY  IH M B EH R AH S IH NG L IY
NEKIK	N AH K IY K
DEPRAVATION  D EH P R AH V EY SH AH N
WOFUL	W OW F AH L
TOUAMEUR	T UW M ER
APPETIZINGLY	AE P AH T AY Z IH NG L IY
INVISIBLES  IH N V IH Z AH B AH L Z
ACKRONNION	AE K R AA N Y AH N
SOPHONISBA	S AH F OW N IH S B AH
TOXICOLOGISTS  T AA K S IH K AA L AH JH IH S T S
SLIKE'S	S L AY K S
TOUSLED	T AH S L D
GRUFFANUFF	G R AH F AH N AH F
PODOLOFF	P AH D OW L AO F
INTUITIVELY  IH N T UW IH T IH V L IY
PICCOLOMINI	P IY K OW L OW M IY N IY
BOTE	B OW T
FRENNETTE	F R IH N EH T
CUSTINE	K UW S T IY N
MAIDES	M EY D Z
SEMITZIN	S EH M IH T S IH N
ASAD'S	AE Z AE D Z
CLAIRAUDIENT	K L EH R AO D IY AH N T
D'ANVERS	D IY AE N V ER Z
AFF	AH F
BRION  B R AY AH N
TABORET	T EY B ER EY
RACER  R EY S ER
DESECRATIONS  D EH Z AH K R EY SH AH N Z
NOATHING	N OW TH IH NG
CHUCKLE  CH AH K AH L
RAINHARBOUR	R AY N HH AA R B ER
POLACCA	P AH L AE K AH
CRUSSOL	K R UW S OW L
SPANGLER  S P AE NG G L ER
OUTSKIRTS  AW T S K ER T S
BILLSON	B IH L S AH N
MARGUERITTE	M AA R G ER IH T
TUTE	T Y UW T
WEE'S	W IY Z
PERLITE  P ER L AY T
UNVEILED  AH N V EY L D
HANDE	HH AE N D
CHARWOMEN  CH AA R W IH M AH N
ALTRO	AO L T R OW
YESSIR	Y EH S IH R
ADMER	AE D M ER
BARMESYDE	B AA R M AH Z AY D
MERCENARIES  M ER S AH N EH R IY Z
EVADES  IY V EY D Z
CONCUSSOR	K AH N K AH S ER
DESCRIPT	D IH S K R IH P T
SNAKEBITE  S N EY K B AY T
TAILLEBOIS	T EY L B W AA
BOOBY'S	B UW B IY Z
OFFICES  AO F AH S IH Z
ECGTHEOW	IH K K TH IY OW
SORY	S ER IY
TUMBLED  T AH M B AH L D
FARRI	F AA R IY
AMINE'S	AH M IY N Z
THUERINGEN	TH UH R IH NG AH N
GIVEN  G IH V IH N
GLENNACLACH	G L EH N AA K L AH K
CLERKING	K L ER K IH NG
DOSHIN	D AA SH IH N
VANNI  V AE N IY
INCINERATION  IH N S IH N ER EY SH AH N
OVERCROWD  OW V ER K R AW D
THRAN	TH R AH N
HOYDENS	HH OY D AH N Z
NATURALISTS  N AE CH R AH L IH S T S
SHABAKO	SH AA B AA K OW
FOTHERINGHAM  F AH DH ER IH NG HH AE M
PHLEGM  F L EH M
PROSSER  P R AO S ER
ZAKHAR	Z AE K ER
VEAU	V OW
WESKITS	W EH S K IH T S
STAUNCHER	S T AO N CH ER
GRAEMER	G R AE M ER
LENGTHY  L EH NG TH IY
COURSING  K AO R S IH NG
CARTWRIGHT'S	K AA R T R AY T S
EXTENSIVELY  IH K S T EH N S IH V L IY
BALLINGALL'S	B AO L IH NG G AO L Z
NEROLI	N AH R OW L IY
MASCOT  M AE S K AH T
PARENTHETICAL  P ER EH N TH EH T IH K AH L
CLUFFE	K L AH F
INFORMATIONAL  IH N F ER M EY SH AH N AH L
GAVRYL	G AE V R AH L
OBERGLAU	OW B ER G L AW
SURVIVED  S ER V AY V D
LUBBER  L AH B ER
GESA'S	G EY S AH Z
SULK  S AH L K
COCONUT  K OW K AH N AH T
CEPHYSE	S EH F AH Z
MINT  M IH N T
CARVEN	K AA R V EY N
PITTITE	P IH T AY T
MAPPIN'S	M AE P IH N Z
BASELESSNESS	B EY S L AH S N AH S
SHOUBRA	SH AW B R AH
SCALI  S K EY L IY
EMPTIED  EH M P T IY D
TEMERAIRE	T EH M ER EY R
MAGISTRATE  M AE JH AH S T R EY T
KAPELLMEISTER	K AH P EH L M AY S T ER
HARLOT  HH AA R L AH T
KRESS  K R EH S
USELESS  Y UW S L AH S
SHAPED  SH EY P T
CATHOLICITY	K AH TH AO L AH S IH T IY
MOLEST  M AH L EH S T
GELID	G EH L IH D
GODDARD  G AA D ER D
DOGRAS	D AO G R AH Z
MAGINOT  M AE JH IH N AA
SEASCALE	S IY S K EY L
ROUMIS	R UW M IY Z
GCALEKAS	G K AH L IY K AH Z
GOSNOLD	G AA S N OW L D
UPSALL	AH P S AH L
SERRIED	S EH R IY D
FLIMSIER	F L IH M Z IY ER
HIRST  HH ER S T
INTERVENER	IH N ER V IY N ER
OFFICERED	AO F AH S ER D
GUINIGI	G W IH N IY JH IY
SPANGENBERG  S P AE NG AH N B ER G
M'GUINNESS	M G W IH N AH S
OUTRIVALLED	AW T R AY V AH L D
SIAMESE  S AY AH M IY Z
AVENGERS	AH V EH N JH ER Z
SCALA  S K AA L AH
GLORIANDE	G L AO R IY AE N D
MARDALE	M AA R D EY L
PICCINI	P IY CH IY N IY
POSEIDON  P AH S AY D AH N
ONE'LL	W AH N AH L
CHICOS	CH IY K OW Z
DISGUSTING  D IH S G AH S T IH NG
CHAUCER  CH AO S ER
STEINBOCK  S T AY N B AA K
FILIUM	F IY L IY AH M
FUNSTON  F AH N S T AH N
BASING  B EY S IH NG
SURVIVING  S ER V AY V IH NG
MAWK	M AO K
JETHRO  JH EH TH R OW
YELLOWHAMMER	Y EH L OW HH AE M ER
KEOLA	K IY AH L AH
CLAVICLES	K L AE V AH K AH L Z
BEHOLDS	B IH HH OW L D Z
ANALYTICALLY  AE N AH L IH T IH K L IY
MEMORIALISTS	M AH M AO R IY AH L IH S T S
FELSMAN	F EH L S M AH N
STORNHAM	S T AO R N HH AH M
SILAS'S	S AY L AH S IH Z
DRILLIN	D R IH L IH N
AMNESTIED	AE M N AH S T IY D
DREDA	D R EY D AH
WIDGETTS	W IH JH IH T S
KIRBY'S  K ER B IY Z
BUITRE	B IH T R IY
O'HOOLIGAN	OW HH UW L IH G AH N
CHAIRO	CH AA IH R OW
MULLANEY  M AH L AH N IY
MADREPORES	M AA D R EY P AO R Z
PROPHET  P R AA F AH T
MARTENS  M AA R T AH N Z
POLICLES	P AA L IH K AH L Z
MATERIEL  M AH T IH R IY EH L
EXCHANGES  IH K S CH EY N JH IH Z
VALID  V AE L IH D
SUSPENSIONS  S AH S P EH N SH AH N Z
SHIKAREES	SH IH K ER IY Z
KASSIMERE	K AE S IH M IH R
RUFFIANLY	R UW F IY AH N L IY
TERAMORE	T EH R AA M AO R
PLADSEN	P L AE D S AH N
ROMANS  R OW M AH N Z
WHALESHIP	W EY L SH IH P
KNEELIN	N IY L IH N
STAMPS'S	S T AE M P S IH Z
GROWERS  G R OW ER Z
ODESSA  OW D EH S AH
CUED  K Y UW D
ANIMAM	AE N AH M AH M
DISBARRED  D IH S B AA R D
HIGGLEDY	HH IH G AH L D IY
BRANCHES  B R AE N CH IH Z
INFINITENESS	IH N F AH N AH T N AH S
SPEEL	S P IY L
SNARLEY	S N AA R L IY
JACKAL  JH AE K AH L
SANTURRI	S AE N T UH R IY
LEO  L IY OW
NULL  N AH L
PLURIMA	P L UH R IY M AH
NIHALI	N IH HH AA L IY
SCRIDAIN	S K R IH D EY N
WONNED	W AH N D
UNSWEETENED	AH N S W IY T AH N D
CROONED	K R UW N D
FELONS  F EH L AH N Z
SHEILA'S  SH IY L AH Z
CALL'D	K AO L D
ILMARINEN'S	IH L M AA R IH N AH N Z
AMPHIBIOUS  AE M F IH B IY AH S
STEERFORTH'S	S T IH R F AO R TH S
UNDERHANDEDNESS	AH N D ER HH AE N D IH D N AH S
MASNI	M AE Z N IY
DEHORNED	D EH HH AO R N D
HISSEF	HH IH S EH F
KISER  K AY Z ER
BURLAP  B ER L AE P
AFTUH	AE F T AH
LEAVENWORTH'S	L EH V AH N W ER TH S
ROLLESTON'S	R OW L S T AH N Z
LIBRIS	L IY B R IY
BLAIRSDALE	B L EH R S D EY L
FEBY	F EH B IY
UNWOODED	AH N W UH D IH D
SEXTET  S EH K S T EH T
REEVE  R IY V
UNSTILLED	AH N S T IH L D
DIGNES	D IH G N Z
ENDEARMENT  IH N D IH R M AH N T
TIMEPIECES	T AY M P IY S IH Z
THOROUGH  TH ER OW
LIMMER  L IH M ER
RA'A'S	R AA AH Z
HOLDS  HH OW L D Z
VANBEEST	V AE N B IY S T
RACONTEUR  R AE K AA N T UW R
GINGHAM  G IH NG AH M
QUERULOUSNESS	K W EH R AH L AH S N AH S
BLACKBIRD'S	B L AE K B ER D Z
WIBORAD	W AY B AO R AE D
LOUISE'S	L UW IY Z IH Z
TERBACCO	T ER B AA K OW
PROSER	P R AA S ER
VERHAGEN  V ER HH AH G AH N
HOMEBREW	HH OW M B R UW
TATHAM'S	T AE TH AH M Z
ROON	R UW N
PARTRIDGE  P AA R T R AH JH
GULGONG	G AH L G AO NG
PLAISE	P L EY Z
ROMERO  R OW M EH R OW
EVANDER'S	IY V AE N D ER Z
BURLACOMBE	B ER L AE K AH M
RUHAR	R UW ER
WHINY  W AY N IY
BROADMEAD	B R AO D M IY D
KETTLE  K EH T AH L
KAZIMBI	K AE Z IH M B IY
ELIZ	EH L IH Z
CHIONE	K IY OW N IY
CARRIAGEWAY	K EH R AH JH W EY
RANTZOW	R AE N T Z OW
MISANTHROPIC	M IH S AH N TH R AH P IH K
ANANOFF	AH N AE N AO F
MUNDAY  M AH N D EY
BATHROBES  B AE TH R OW B Z
STAPLETONS	S T EY P AH L T AH N Z
TOQUE	T AA K W EH
SERGAI	S EH R G AY
ETHELDREDA	EH TH IH L D R EH D AH
ASPIDISTRAS	AE S P IH D IH S T R AH Z
ASSUAGES	AH S W EY JH IH Z
INCREASINGLY  IH N K R IY S IH NG G L IY
CONTEMN	K AH N T EH M
MAZZINI	M AA T S IY N IY
SEXTUPLE	S EH K S T AH P AH L
GROOTZ'S	G R UW T S IH Z
SMEARCASE	S M IH R K EY S
ABDULLA'S	AA B D UW L AH Z
FOUNDING  F AW N D IH NG
ERNSTHAUSEN	ER N S T HH AW Z AH N
KAUAI  K AW AY
COMPAGNIES	K AH M P AH N IY Z
EXPECTANTS	IH K S P EH K T AH N T S
BASTINADOES	B AE S T AH N AA D OW Z
HYPOTHENUSE	HH AY P AA TH AH N Y UW Z
MADERSLEY	M AE D ER S L IY
SHANGRI  SH AE NG G R IY
NOTOCHORD  N OW T AH K AO R D
SHAUGHNASSY	SH AO N AH S IY
THUMP  TH AH M P
CRYPTS  K R IH P T S
E'LL	IY L
PIFFARD	P IH F ER D
VISAYAN	V IH S AY AH N
HOPPEDIZEL	HH AA P IH T IH Z AH L
KISSINGEN	K IH S IH NG G EH N
CRADDOCK'S	K R AE D AH K S
ROILY	R OY L IY
EFFERVESCE	EH F ER V EH S
PARALLELED  P EH R AH L EH L D
SCUPHAM	S K AH P AH M
SLENDERLY	S L EH N D ER L IY
TADOUSSAC	T AE D UW S AE K
ODETTE  OW D EH T
OSWALD'S  AO Z W AO L D Z
LODGETH	L AA JH IH TH
CHAUNTSEY	CH AO N T S IY
RAGLAND  R AE G L AH N D
FARDALE'S	F AA R D EY L Z
GELFHARDT	JH EH L F HH AA R T
VIAS	V IY AH Z
DISCERNINGLY	D IH S ER N IH NG L IY
KULI	K Y UW L IY
DASHBOARD  D AE SH B AO R D
SYMPSON  S IH M P S AH N
SHIBLI	SH IH B L IY
IST'S	IH S T S
DELLINGHAM	D EH L IH NG HH AE M
DEWLAP	D UW L AE P
ANERLEY	AE N ER L IY
EXCHANGED  IH K S CH EY N JH D
ROTO  R OW T OW
SIMEON'S	S IH M IY AH N Z
SEBASTIANA  S AH B AE S T IY AA N AH
MONTE'S  M AA N T IY Z
WINGED  W IH NG D
MARTLETT	M AA R T L IH T
LITTLEWORTHY	L IH T AH L W ER DH IY
CHARLADY	CH AA R L AH D IY
SCIENTIAE	S AY AH N T IH AY
GUBERNATOR	G UW B ER N EY T ER
ANTRO	AE N T R OW
KATLEEAN	K AE T L IY AH N
MEASSEFIM	M IY Z S IH F IY M
NEMORALIS	N IH M ER AE L IH S
ASPRAY	AE S P R EY
HAUGHTON'S	HH AO T AH N Z
OWLET'S	AW L IH T S
BRANCH'S  B R AE N CH IH Z
RAROTONGA	R AE R AH T AA N G AH
NETHERFIELD	N EH DH ER F IY L D
BRAINES	B R EY N Z
TRANSLATOR  T R AE N S L EY T ER
SENTINELS  S EH N T AH N AH L Z
TWITCHY	T W IH CH IY
MITRAILLEUSES	M IH T R AH L Z AH Z
MYSEL'	M AY S EH L
O'MY	OW M IY
UNTERSEE	AH N T ER S IY
LANESPORT	L AE N S P AO R T
PAULIST	P AO L IH S T
NEIGHBOUR	N EY B ER
PREXY	P R EH K S IY
FATHERS  F AA DH ER Z
SOHMER  S OW M ER
PUGILIST'S	P Y UW JH AH L IH S T S
MANNEQUINS  M AE N AH K IH N Z
STURGEONS  S T ER JH AH N Z
WEARYIN	W IY R IY IH N
CREIGHTON  K R EY T AH N
PUNISHER  P AH N IH SH ER
SHEPHERDLESS	SH EH P ER D L AH S
ENFANTIN	AA N F AA N T IH N
GERVAISE	ZH ER V EY Z
LIEUTS	L UW T S
ABASH'D	AH B AE SH D
MERWYN'S	M ER W IH N Z
AOYAMA  AW Y AA M AH
RAIDS  R EY D Z
IMBERT'S	IH M B ER T S
HAMANDO	HH AH M AA N D OW
ITALIA  IY T AE L IY AH
GUTHLAC'S	G AH TH L AE K S
OBSARVED	AH B S AA R V D
PERPETUAL  P ER P EH CH UW AH L
ADLER'S  AE D L ER Z
ACHY  EY K IY
PERSICA	P ER S IY K AH
MOOZUFFERNUGGAR	M UW Z UW F ER N AH G ER
DIRECTORY  D IY R EH K T ER IY
BONANZAS	B OW N AA N Z AA Z
ATTWELL	AE T W EH L
LIBBY'S	L IH B IY Z
DARVAN	D AA R V AH N
MASTERTON	M AE S T ER T AH N
WAVERTREE	W EY V ER T R IY
O'BOTTOM	OW B AH T AA M
DAINTILY	D EY N T AH L IY
COURONNES	K AO R AH N Z
DRAM  D R AE M
MERRYLEGS	M EH R IY L EH G Z
PRINCIPUM	P R IH N S AH P AH M
KAREWENDA	K EH R W EH N D AH
MUSSEL  M AH S AH L
GAIRDNER	G EH R D N ER
WOODVALE	W UH D V EY L
RONCADOR	R OW N K AH D AO R
CORNY'S	K AO R N IY Z
HENERY'S	HH EH N ER IY Z
ELDERSHIP	EH L D ER SH IH P
DONOHUE  D AA N AH HH Y UW
ARGA	AA R G AH
GARNISHMENT  G AA R N IH SH M AH N T
MOTO  M AA T OW
YOLARA'S	Y OW L AA R AH Z
TONER'S	T OW N ER Z
COUNT  K AW N T
TRUMAN  T R UW M AH N
EVANGELISING	IY V AE N JH AH L IH S IH NG
HEINSIUS	HH AY N S IY AH S
ABABA  AH B AA B AH
SOCKNA	S AA K N AH
TEST  T EH S T
SEXAGESIMA	S EH K S AE G EH S IY M AH
BOHAIN	B OW AY N
EIMEO	AY M IY OW
VARRO	V AA R OW
AYMON	EY M AH N
MANCA	M AE NG K AH
RUTHERFURD	R AH TH ER F ER D
CONCENTRATOR	K AA N S AH N T R EY T ER
D'ARQUES	D AA R K S
UNCERTAINTIES  AH N S ER T AH N T IY Z
OOLITIC	UW L IH T AH K
LILJEKRONA	L IH L JH IH K R OW N AH
TICKIT	T IH K IH T
BUBIS	B UW B IH S
XLIV	Z L IY V
DAATJE	D AA T Y AH
NEUBRUNN	N UW B R AH N
ELMER'S	EH L M ER Z
WADHERIM	W AO D HH IH R IH M
RAFALSKI  R AH F AA L S K IY
PECORINO	P EH K AO R IY N OW
WHICKER  HH W IH K ER
IMPLIED  IH M P L AY D
EXHAUSTS  IH G Z AO S T S
EMMERSON  EH M ER S AH N
PRIMMIE	P R IH M IY
ZEALAND  Z IY L AH N D
WATRY  W AA T R IY
ELIAB'S	AH L AY AH B Z
YEASAY	Y IY S EY
TOOLHOUSE	T UW L HH AW S
SAXON  S AE K S AH N
PAEON	P IY AA N
HARDON	HH AA R D AH N
TEMOIN	T IH M OY N
SALTILLO	S AO L T IH L OW
SAFEGUARDED  S EY F G AA R D IH D
SEMBLABLE	S EH M B L AH B AH L
MALLOW  M AE L OW
SPINED	S P AY N D
WOULD  W UH D
VRYHEID	V R IY HH AY D
PROTUBERANCES  P R OW T UW B ER AH N S AH Z
SPRINKLES  S P R IH NG K AH L Z
PETALA	P EH T AH L AH
INFLAMMABLE  IH N F L AE M AH B AH L
LONGA	L AA NG G AH
FOXY  F AA K S IY
RESPONSE  R IY S P AA N S
VOCATION  V OW K EY SH AH N
ELAPSE  IH L AE P S
JAH	JH AH
OENONE	IY N AH N
DEEMED  D IY M D
UNELECT	AH N IH L EH K T
ELEANOR  EH L AH N ER
UTTERDEN	AH T ER D AH N
VENTIMORE	V EH N T AH M AO R
BIGOTED  B IH G AH T IH D
AIMAND	EY M AH N D
BEAULY	B OW L IY
CRUELTY  K R UW L T IY
JOSSELYN'S	JH AA S IH L IH N Z
TONGS  T AO NG Z
EVADNA	IH V EH D N AH
TRANSCENDENT  T R AE N S EH N D AH N T
ALLUDIN	AH L UW D IH N
ASCRIBING	AH S K R AY B IH NG
HEBE  HH IY B
KATHIE  K AE TH IY
TEINT	T EY N T
DANDRUFF  D AE N D R AH F
LIDDLE  L IH D AH L
FORSEEING	F ER S IY IH NG
ROOKING	R UH K IH NG
GLYNDON	G L IH N D AH N
MANICHEAN	M AA N IY K IY AH N
SNATCHER  S N AE CH ER
THOMASES  T AA M AH S IH Z
ZIONISTS  Z AY AH N IH S T S
BRETONS	B R EH T AH N Z
GANADO	G AA N AA D OW
REGAINS  R IY G EY N Z
UNCLOSE	AH N K L OW Z
TAYLOUR	T EY L ER
ZEHRENDORF	Z EH R IH N D AO R F
IMMIGRATE  IH M AH G R EY T
SOFTY	S AO F T IY
SKURRIED	S K ER IY D
AMONGST  AH M AH NG S T
EMBELLISHMENT  EH M B EH L IH SH M AH N T
GRANULAR  G R AE N Y AH L ER
WIDEAWAKE	W AY D AH W EY K
ILLUMINE	IH L UW M AH N
AYSGARTH	EY S G AA R TH
VOYVODA	V OY V OW D AH
ELYSIANS	IH L IY ZH AH N Z
LULLABYS	L AH L AH B IY Z
BERRIDGE  B EH R IH JH
LYNWOOD'S	L IH N W UH D Z
MINDE	M AY N D
BOVE  B OW V
EPIGRAMS	EH P AH G R AE M Z
WINCES	W IH N S IH Z
OTO	OW T OW
GRAAF	G R AA F
CHOPPED  CH AA P T
COURTLY  K AO R T L IY
CAISTEAL	K EY S T IY L
CANVASBACKS	K AE N V AH S B AE K S
RUNNINGBROOK	R AH N IH NG B R UH K
EDUCATORS  EH JH Y UW K EY T ER Z
BAHS	B AA Z
GRAPPLE  G R AE P AH L
VICK'S	V IH K S
KARAGEORGE	K AE R AH JH AO R JH
WAGER  W EY JH ER
JOCHEM  JH AA K IH M
MAINYARD	M EY N Y AA R D
GILLE  G AY L
JANNETTE	JH AH N EH T
PLATITUDE  P L AE T IH T UW D
GAOLERS	G AA OW L ER Z
VAVASOR'S	V AA V AH S ER Z
ORGASM  AO R G AE Z AH M
CANANDAIGUA  K AE N AH N D EY G W AH
FORO	F AO R OW
BARANG	B AA R AA NG
BRYERLY'S	B R AY ER L IY Z
ATLANTIC'S  AH T L AE N T IH K S
MAPPED  M AE P T
TOTALED  T OW T AH L D
PROCONSUL  P R OW K AA N S AH L
CAPPIE	K AE P IY
PRESUMED  P R IY Z UW M D
BREITMANN'S	B R AY T M AH N Z
ROASTED  R OW S T IH D
MERLI	M ER L IY
JAVELIN  JH AE V L AH N
LAMAN  L EY M AH N
MIDPOINT  M IH D P OY N T
CONSIGNOR	K AA N S IY N Y AO R
CHAKA	CH AA K AH
GEORGIANA'S	JH AO R JH IY AE N AH Z
FANCIEST  F AE N S IY AH S T
FOOLISHEST	F UW L IH SH AH S T
KABANOVA	K AE B AH N OW V AH
ANALYSING	AH N AE L AH S IH NG
SOBIESKA	S OW B IY EH S K AH
ZEEBA	Z IY B AH
GRADUATE  G R AE JH AH W AH T
GRAYLING  G R EY L IH NG
OXBRIDGE  AA K S B R IH JH
CODGER'S	K AA JH ER Z
PORTAL'S	P AO R T AH L Z
HUNTERSFIELD	HH AH N T ER Z F IY L D
WREAKING  R IY K IH NG
SETUP  S EH T AH P
LOGGERHEADS  L AA G ER HH EH D Z
PYRITE  P AY R AY T
CROUDED	K R AW D IH D
DESIRABLE  D IH Z AY ER AH B AH L
FISCUS  F IH S K AH S
GODIVA  G AH D AY V AH
PERSUASIVE  P ER S W EY S IH V
EYEWITNESS  AY W IH T N AH S
FLADDA	F L AE D AH
POACHING  P OW CH IH NG
FAIRYLIKE	F EH R IY L AY K
VALLON'S	V AE L AH N Z
GARRICK'S	G AE R IH K S
BIOLOGIST  B AY AA L AH JH IH S T
EPITHETS  EH P AH TH EH T S
ELMAZE	EH L M EY Z
CRETEIL	K R IY T IY L
ARDAL	AA R D AH L
PROTUS	P R OW T AH S
EXCELLENZ	EH K S L EH N Z
HAZEBROUCK	HH EY Z B R UH K
ISLETA	AY L IH T AH
POMPTON	P AA M P T AH N
LACKEST	L AE K AH S T
CADORE	K AA D AO R EY
DAMER'S	D EY M ER Z
KORYNTHIA	K AO R IH N TH IY AH
DIFFIDENT	D IH F AH D AH N T
OAJACA	OW AY AH K AH
MERICUS	M EH R IH K AH S
SALZBRUECK	S AO L Z B R AH K
AQUILEIA	AE K W AH L EY AH
CORED	K AO R D
JEE'S	JH IY Z
FRAMLEY	F R AE M L IY
ALEXEI  AH L EH K S EY
HASSOCK	HH AE S AH K
OREB	AO R EH B
MASTERS'S	M AE S T ER Z IH Z
RECHARGED  R IY CH AA R JH D
CARMACK'S	K AA R M AH K S
AGGRANDIZE  AH G R AE N D AY Z
WORLDER  W ER L D ER
DAMGHAN	D AE M G AH N
STEKEL	S T EH K AH L
BROGUES	B R OW G Z
CONDESCENSION  K AA N D AH S EH N SH AH N
DEFYING  D IH F AY IH NG
WIZZENED	W IH Z AH N D
DIRECTNESS  D IY R EH K N AH S
WRECK  R EH K
EVERET'S	EH V R AH T S
TOOTHED  T UW TH T
AUVERNOIS	AW V ER N W AA
THORPE  TH AO R P
AUKWARDNESS	AW K W ER D N AH S
HIMATION	HH AH M EY SH AH N
DANUSCO	D AE N Y AH S K OW
MITTACHIP'S	M IH T AH SH IH P S
OGILVIES	AA JH IH L V IY Z
MARAMBOT	M AA R AA M B OW
MEDICINES  M EH D AH S AH N Z
EUST	Y UW S T
ACROSS  AH K R AO S
ABREK	AH B R IH K
YONSON	Y AA N S AH N
RELIABILITY  R IY L AY AH B IH L AH T IY
SHELDONS	SH EH L D AH N Z
CHATER'S	SH AH T ER Z
SOUTHERNWOOD	S AH DH ER N W UH D
VILLES	V IH L Z
HARBORD	HH AA R B ER D
SALZ  S AO L Z
FROHLICH  F R OW L IH K
HOMECROFT	HH OW M K R AO F T
ALRETTY	AO R EH T IY
STESSO	S T EH S OW
ANAEMIA	AE N IY M IY AH
CROPSEY  K R AA P S IY
WISTFUL  W IH S T F AH L
BUTTERLESS	B AH T ER L AH S
SLOVAK  S L OW V AA K
WADA  W AA D AH
SPECIALIZED  S P EH SH AH L AY Z D
FAROUCHE	F AH R UW SH
MISCHIEF'S	M IH S CH IY F S
LUTE'S	L UW T S
TALK  T AO K
LEVIVE	L AH V AY V
NONCOMBATANTS  N AA N K AH M B AE T AH N T S
CONDUCTING  K AH N D AH K T IH NG
FLEURS	F L ER Z
GID	G IH D
MOTORING  M OW T ER IH NG
PARKMAN'S	P AA R K M AH N Z
OBEN	AA B AH N
STRICTER  S T R IH K T ER
MONSIGNORE	M AA N S IY N Y AO R EY
LISHA	L IH SH AH
DECREPIT  D AH K R EH P IH T
CLARIBEL  K L EH R AH B EH L
STRATHSAY'S	S T R AE TH S EY Z
TORPANDER	T AO R P AE N D ER
ROSMIN	R AA Z M IH N
MEEJOR	M IY JH ER
LEICHT  L AY K T
DARS	D ER Z
COGIA'S	K OW JH IY AH Z
UTTERINGS	AH T ER IH NG Z
TACUBA	T AE K Y AH B AH
PARIS'S  P EH R IH S IH Z
ROCROY	R AA K R OY
CULMINATIONS	K AH L M AH N EY SH AH N Z
UNIVALVE	Y UW N IH V AE L V
VETS  V EH T S
MUIRDEN	M Y UH R D AH N
EPERIES	EH P ER IY Z
CAPITAINE	K AE P AH T EY N
PURITANICALLY	P Y UH R AH T AE N IH K L IY
COBURG	K OW B ER G
UNTAMEABLE	AH N T AE M IY AH B AH L
GENI	JH IY N IY
ARRIV'D	ER AY V D
PUNISHMENT  P AH N IH SH M AH N T
YEARLINGS  Y ER L IH NG Z
CACOPHONY  K AE K AA F AH N IY
LENORMANT	L AH N AO R M AH N T
BUMPPO	B AH M P OW
THRIDDING	TH R IH D IH NG
HEBRIDES  HH EH B R IH D IY Z
FORTES  F AO R T S
BEARER'S	B EH R ER Z
WESTWOOD'S  W EH S T W UH D Z
SCATCHERD	S K AE CH ER D
DORRIS'S	D AO R IH S IH Z
OVERCOATS  OW V ER K OW T S
MARTINSON  M AA R T IH N S AH N
AZAZEL	AH Z AE Z AH L
ANTHROPOIDS	AE N TH R AH P OY D Z
LACHMANN	L AE K M AH N
TAYPOT	T EY P AA T
OFICIAL	OW F IH SH AH L
UNDOMESTIC	AH N D AH M EH S T IH K
ARMATHWAITE'S	AA R M AA TH W EY T S
ANGELICA  AE N JH AH L IY K AH
BEAULIEU  B OW L Y UH
STRATHMOIRA	S T R AE TH M OY R AH
SEITZ  S AY T S
SALEM  S EY L AH M
WEITZMANN	W AY T S M AH N
BALDHEAD	B AO L D HH EH D
VITUPERATIVE  V AY T UW P ER AH T IH V
MEISTER'S	M AY S T ER Z
ZANCHE	Z AH N SH
RETAINS  R IH T EY N Z
THANK'YE	TH AE NG K AY
PHRIXUS	F R IH K S AH S
MALLA	M AE L AH
LOVENJOUL	L AH V AH N JH UW L
ENFOLDED	IH N F OW L D AH D
SIDLING  S AY D L IH NG
ARROW  AE R OW
PENGE	P EH N JH
ERSTEN'S	ER S T AH N Z
VOMITING  V AA M AH T IH NG
DISPREAD	D IH S P R EH D
DRABBLED	D R AE B AH L D
ULVA  UW L V AH
CONTROL  K AH N T R OW L
RAFTERY'S	R AE F T ER IY Z
REGIONAL  R IY JH AH N AH L
FORDAK	F AO R D AH K
VORKULIAN	V AO R K UW L IY AH N
NEBR	N AH B R
HASAYAMPA	HH AE S AA Y AA M P AH
NOBUNAGA	N OW B UW N AA G AH
ACHARNEMENT	AH CH AA R N AH M AH N T
MANAGING  M AE N AH JH IH NG
HENRIQUES  HH EH N R IY K EH Z
BELITTLEMENT	B IH L IH T AH L M AH N T
RODOLPHE'S	R OW D AA L F AH Z
KAPERTON	K AE P ER T AH N
GRID'S  G R IH D Z
CHAWBACONS	CH AO B EY K AH N Z
LANDGRAVINE	L AE N JH R AH V IY N
MESSUA	M EH S UW AH
MANSOURAH	M AE N S ER AH
POSSESSEST	P AH Z EH S IH S T
DRAKE  D R EY K
PEOPLE  P IY P AH L
UPSTANDING  AH P S T AE N D IH NG
STUBBY  S T AH B IY
FUROSHIKI	F UH R OW SH IY K IY
WINDT'S	W IH N T S
UNPLEASANT  AH N P L EH Z AH N T
MAGGIES	M AE G IY Z
TICKINGS	T IH K IH NG Z
COIT  K OY T
MALAHIDE  M AE L AH HH AY D
ASPIRANTS  AH S P AY R AH N S
INVECTIVE  IH N V EH K T IH V
ABERDEENSHIRE	AE B ER D IY N SH AY R
SNIDER'S	S N AY D ER Z
TANGROUILLE	T AE NG R UW IY
SLEEK  S L IY K
REFORM  R AH F AO R M
PLEASURE  P L EH ZH ER
TANNENBURG	T AE N AH N B ER G
LAUNFAL	L AO N F AA L
OUZELFORD	AW Z EH L F ER D
SCANNER  S K AE N ER
PARROQUET	P AA R OW K EY
PORRO  P AO R OW
LUE  L UW
SUPPERING	S AH P ER IH NG
WAYFARER	W EY F EH R ER
TAOIST  D AW IH S T
EPOCHS  EH P AH K S
CONVALESCED	K AA N V AH L EH S T
DALENS	D AE L AH N Z
COMPTE	K AH M P T
OXHEAD	AA K S HH EH D
GALES  G EY L Z
TILLIE'S	T IH L IY Z
DESPENSER	D EH S P EH N S ER
SEPARATORS	S EH P ER EY T ER Z
COSTER'S	K AA S T ER Z
GLINN	G L IH N
BUEIL	B Y UW IY L
COPTER	K AA P T ER
PAWLING  P AO L IH NG
SILHOUETTES  S IH L AH W EH T S
MANTLE'S  M AE N T AH L Z
CONVEY  K AH N V EY
BRADFORD'S  B R AE D F ER D Z
MANSOS	M AE N S OW Z
DRAMS  D IY R AE M Z
VEZINS	V EH Z IY N Z
ALMONDS  AA L M AH N D Z
KARIM'S	K ER IY M Z
SUSPENDING  S AH S P EH N D IH NG
VOLSTRUIS	V OW L S T R UW IH Z
ODHAINAT	AA D HH AY N AH T
ALLEGATIONS  AE L AH G EY SH AH N Z
BILLING  B IH L IH NG
FLEXURES	F L EH K S Y UH R Z
HOLLIS'S	HH AA L IH S IH Z
UNWED  AH N W EH D
NOBELA	N OW B EH L AH
STRONGHEART	S T R AO NG HH AA R T
OPIE'S	OW P IY Z
SPOOFING  S P UW F IH NG
LAYMAN  L EY M AH N
HE'PED	HH IY P T
POTTAWATOMIE	P AA T AH W AA T AH M IY
PROUT  P R AW T
PRAI	P R AA IY
TAXABLE  T AE K S AH B AH L
UMSUKA	AH M S UW K AH
BURIES  B EH R IY Z
BILBIL'S	B IH L B AH L Z
PIPIRI	P IH P IH R IY
DROPPETH	D R AA P IH TH
WOODBINE	W UH D B AY N
DOONES	D UW N Z
MONTORS	M AA N T ER Z
NADA'S	N AA D AH Z
CHISANE	CH IH Z AH N
MARTYNS	M AA R T IH N Z
RAMBUNCTIOUS  R AE M B AH NG K SH AH S
REGULARITIES	R EH G Y AH L EH R AH T IY Z
HOPPY'S	HH AA P IY Z
EH  EH
LOTTE  L AA T
OPAR	OW P AA R
GRANDMA'S  G R AE M AA Z
CADUCEUS	K AH D UW CH IY AH S
PHIN	F IH N
TRANSCENDENTALIST	T R AE N S AH N D EH N AH L IH S T
CONVERTITES	K AA N V ER T AY T S
STRATAGEM  S T R AE T AH JH AH M
AMASI	AA M AA S IY
BODENSEE	B OW D AH N S IY
PINCH'D	P IH N CH D
RAMADAN  R AE M AH D AH N
GITL	JH IY T AH L
WUDDENT	W AH D AH N T
JAS  JH AE S
BITTERSWEET  B IH T ER S W IY T
ROCHECLIFFE	R AA CH EH K L IH F
CONSTANTINE'S	K AA N S T AH N T AY N Z
LIVERIES	L IH V R IY Z
FACILITATES  F AH S IH L AH T EY T S
ROCHERS	R OW CH ER Z
EYEBROW  AY B R AW
TARRYTOWN  T EH R IY T AW N
TOPSIDE	T AA P S AY D
HAV'NT	HH AE V AH N T
FIGCHEN	F IH G CH AH N
APPRAISER  AH P R EY Z ER
UNSOCIABLE	AH N S OW SH AH B AH L
RINGGOLD  R IH NG G OW L D
KID'S  K IH D Z
REMODELS	R IY M AA D AH L Z
GUILLOTINE  G IY Y AH T IY N
YERS	Y ER Z
WEMYSS	W EH M IH S
DOLIUS	D OW L IY IH S
RUING	R UW IH NG
SOUR  S AW ER
CRONNIN	K R AA N IH N
REEFER  R IY F ER
REDOUBLING  R IY D AH B AH L IH NG
EXCALIBAR	EH K S K AE L AH B AA R
TORFRIDA'S	T AO R F R IH D AH Z
AYCLOUGH	EY K L AW
MAYOR  M EY ER
RELF  R EH L F
TAUTEN	T AW T AH N
ZICARU	Z IH K ER UW
LOFTGREEN	L AO F T G R IY N
CAILLET	K EY L AH T
DENIERS	D IH N AY ER Z
SYRIA'S  S IH R IY AH Z
SHAKESPEAR	SH EY K S P IY R
LIMOURS	L IH M ER Z
WINDLASS  W IH N D L AH S
RIOTOUSNESS	R AY AH T AH S N AH S
DART'S  D AA R T S
WAYLAND'S	W EY L AH N D Z
CRAIGS	K R EY G Z
XXXVII	Z K S V IY
GOODWOOD	G UH D W UH D
CADENT	K AH D AH N T
SOPORIFEROUS	S AA P ER IH F ER AH S
DAME'S  D EY M Z
LOATHSOMENESS	L OW DH S AH M N AH S
REGA  R IY G AH
MEDICALS	M EH D IH K AH L Z
RECLAIMING  R IY K L EY M IH NG
BUNKERED	B AH NG K ER D
DISDAINFULLY	D IH S D EY N F AH L IY
VEDETTES	V IH D EH T S
BROUGHAM'S	B R UW G AH M Z
GREENGROCER'S	G R IY N G R OW S ER Z
CROISSANT  K W AA S AA N T
LATET	L AA T EH T
TENSKWATAWA	T EH N S K V AH T AA W AH
RULAN	R UW L AH N
TOO  T UW
CULP  K AH L P
CONQUER  K AA NG K ER
HARVESTED  HH AA R V AH S T AH D
BRAGH	B R AE G
DORAS	D AO R AH Z
DUMB  D AH M
ENGENDER  EH N JH EH N D ER
MENTALITY  M EH N T AE L IH T IY
CAM'S  K AE M Z
RASHERS	R AE SH ER Z
BUELL  B Y UW AH L
APPALACHIAN  AE P AH L EY CH AH N
DRUSE'S	D R UW Z IH Z
APICULTURE	AE P IH K AH L CH ER
TWEENY	T W IY N IY
THEMIS	TH IY M AH S
AHRIMANES	AA R IH M EY N Z
CORDWAINER	K AO R D W EY N ER
UNZIAR	AH N Z IH R
VERBOSE	V ER B OW Z
SQUID  S K W IH D
TAGATI	T AA G AA T IY
UNSURPASSED  AH N S ER P AE S T
KEITLOA	K AY T L OW AH
BORED  B AO R D
HARBORING  HH AA R B ER IH NG
MAKS	M AE K S
DAURA	D AO R AH
FORSYTHIA  F AO R S IH TH IY AH
DICTYS	D IH K T IY Z
VEXES	V EH K S IH Z
SHIRTCLOAK	SH ER T K L OW K
EUCLID  Y UW K L IH D
TINEA	T IH N IY AH
BARR'S  B AA R Z
TWARN'T	T W AO R N T
HYDROCHLORIC	HH AY D R AA K L AO R IH K
UBANGI	Y UW B AA N JH IY
CALONICE	K AA L OW N IY S
SANDHURST	S AE N D HH ER S T
ALPINI	AE L P IY N IY
PROOFREADING  P R UW F R IY D IH NG
TII	T IY
UTTER  AH T ER
COVAJOS	K OW V AH HH OW Z
HAZELWOOD  HH EY Z AH L W UH D
KIRKES	K ER K S
DEBILITATING  D AH B IH L AH T EY T IH NG
BANJOS	B AE N JH OW Z
N'YAWK	N Y AO K
READMISSION	R IY AH D M IH SH AH N
POSSY	P AA S IY
THOTHMES	TH AA TH M Z
CONTENT  K AH N T EH N T
PALADA	P AH L AA D AH
OP'RY	AA P R IY
YO'S	Y OW Z
PUNKINS	P AH NG K IH N Z
ESTUDILLO	EH S CH UW D IH L OW
SMUGGLING  S M AH G L IH NG
POLKINGHORNE	P OW L K IH NG HH AO R N
TANIA  T AA N Y AH
BOOTBLACK'S	B UW T B L AE K S
PONTOONS  P AA N T UW N Z
SANDTOWN  S AE N D T AW N
EXPLOITS  EH K S P L OY T S
VETTERN	V EH T ER N
HENDER'S	HH EH N D ER Z
D'AUMALE	D AO M EY L
COSMOPOLITANISM	K AO Z M AH P AA L AH T AH N IH Z AH M
CROPPO	K R AA P OW
ANTITHETICAL  AE N T AH TH EH T IH K AH L
CAPITALS  K AE P IH T AH L Z
CISTERNAS	S IH S T ER N AH Z
JAI  HH AY
SOMATOLOGY	S OW M AH T AA L AH JH IY
ZACHARIAH'S	Z AE K ER AY AH Z
AUTOMOBILIST	AO T AH M OW B IY L IH S T
MUSKAU	M AH S K AW
MEDULLA  M IH D UW L AH
KALAMAKE	K AE L AH M EY K
STARBRIGHT	S T AA R B R AY T
APHIDS  EY F AH D Z
HUMAINES	HH AH M EY N Z
RESENTFULLY	R IH Z EH N T F AH L IY
MARTHE'S	M AA R DH AH Z
GRANDFEYTHER	G R AE N D F AY DH ER
UNWIELDLY	AH N W IY L D L IY
BABINGTONS	B AE B IH NG T AH N Z
STARRETT  S T AE R IH T
BILLY'LL	B IH L IY AH L
WINKELMANN  W IH NG K AH L M AH N
SHARDS  SH AA R D Z
COCKSWAIN	K AA K S W EY N
GOODA  G UH D AH
DINEWAN	D AY N W AA N
SIENNESE	S IY EH N IY S
DRAGGED  D R AE G D
SULPHATE  S AH L F EY T
RUCHES	R AH CH IH Z
TAPIOCA	T AE P IY OW K AH
GODFREYS	G AA D F R IY Z
DIVINES	D IH V AY N Z
VARMINT'S	V AA R M IH N T S
HUND'ED	HH AH N D
PITCHING  P IH CH IH NG
CREDITED  K R EH D AH T AH D
WOTTING	W AA T IH NG
BILLHOOK	B IH L HH UH K
EXPOSING  IH K S P OW Z IH NG
CHION	CH AH N
LANGHOPE	L AE NG HH OW P
EXCUSE  IH K S K Y UW S
SMOTH	S M AA TH
NISSA  N IH S AH
VAORNIA	V AO R N IY AH
TAVERNEY	T AA V EH R N IY
LUBRICITY	L UW B R IH S IH T IY
CHETWYND	CH EH T W IH N D
PYRUS	P IH R AH S
ENCORES  AA N K AO R Z
SHEDDER	SH EH D ER
ENTERPRISE  EH N T ER P R AY Z
WOOIN	W UW IH N
PO'LY	P OW L IY
VIRIDUS	V IH R IH D IH S
HELLS	HH EH L Z
GLUMDALCLITCH	G L AH M D AH L K L IH CH
SIRAJ	S IH R AA ZH
CARMAN  K AA R M AH N
ASHBORNE	AE SH B AO R N
DISHON  D IH S AH N
HOG'S	HH AA G Z
INAUGURAL  IH N AO G ER AH L
SUSANNA'S	S UW Z AE N AH Z
BLOWEN	B L OW AH N
MALIKOWSKY	M AE L IH K AW S K IY
CLAVIUS	K L EY V IY IH S
DISHONESTLY  D IH S AO N AH S T L IY
WOODCRAFTERS	W UH D K R AE F T ER Z
SILVIANE'S	S IH L V IY AH N Z
MBOLO	M B OW L OW
DISREPUTE  D IH S R IH P Y UW T
FUMBLES  F AH M B AH L Z
CZAR'S  Z AA R Z
PURISIMA	P UH R IY S IY M AH
OLENKA	OW L EH NG K AH
PLAUDIT  P L AO D IH T
RENTE	R EH N T EY
NAPA  N AE P AH
GALILEI	G AE L AH L EY IY
ATTENUATING	AH T EH N Y UW EY T IH NG
BOUILLI	B UW L IY
LISNER	L IH S N ER
MERIDEN  M EH R IH D AH N
DEINE	D IY N
FRIT	F R IH T
BESTRIS	B EH S T R IH S
LITHL	L IH TH L
PEDANT	P EH D AH N T
LINTIE	L IH N T IY
POUNDS  P AW N D Z
FRIEDRICHSHAFEN	F R IY D R IH K SH AH F AH N
MANYDOWN	M EH N IY D AW N
MANFREDONIA	M AE N F R IH D OW N IY AH
GRAVESTONE  G R EY V S T OW N
ENONE	IH N OW N IY
NEGAT	N EH G AH T
WEDGES  W EH JH AH Z
CATACLYSMIC  K AE T AH K L IH Z M IH K
LEGGATT	L EH G AH T
BARRIERES	B AA R IH R Z
FLIETH	F L AY IH TH
CENTAUR'S  S EH N T AO R Z
SULPICIAN	S UW L P IH SH AH N
BERTHELINI	B ER TH AH L IY N IY
CHAMU	CH AA M UW
CHARMOY	CH AA R M OY
GROWLING  G R OW L IH NG
HUSSEIN  HH UW S EY N
DESERTING  D EH Z ER T IH NG
SANGDIEU	S AE NG D UW
POLDER  P OW L D ER
BUZ	B Y UW Z
EMPHASIS  EH M F AH S AH S
CATCHER  K AE CH ER
ROWE  R OW
CONSTITUENTS  K AH N S T IH CH UW AH N T S
TUETZI	T UW T Z IY
FFORDE	F AO R D
RUDDERS	R AH D ER Z
SAUER  S AW ER
WISSANT	W IH S AH N T
ANNIUS	AE N IY IH S
RYBURGH	R IH B ER G
FIRSTSPACER	F ER S T S P EY S ER
SNUFFERS	S N AH F ER Z
CHAPERON	SH AE P ER OW N
L'ARCHE	L AA R CH
SMEAR  S M IH R
STEET	S T IY T
LATTERMAN	L AE T ER M AH N
STAVOREN	S T AH V AO R AH N
TORQUATO	T AO R K W AA T OW
IMMEMORABLE	IH M EH M ER AH B AH L
PHARMACISTS  F AA R M AH S IH S T S
CHRISTLIKE	K R IH S T L AY K
SPRYEST	S P R AY AH S T
PONDEL	P AA N D AH L
TAXING  T AE K S IH NG
PARMALEE'S	P AA R M AH L IY Z
LITTLETON  L IH T AH L T AH N
WASSAILERS	W AO S EY L ER Z
ATTAKAPAS	AE T AH K AA P AH S
NAGDEO	N AE G D EY OW
BAMBOO  B AE M B UW
LORRINGTON	L AO R IH NG T AH N
FLOYER	F L OY ER
MODISTES	M OW D IH S T S
JELI	JH EH L IY
BROADFIRTH	B R AO D F ER TH
DARDANIAN	D AA R D EY N IY AH N
PAPWITH	P AE P W IH TH
BUCCAROOS	B UW K ER UW Z
DYKED	D AY K T
OVENBIRD	AH V AH N B ER D
MUGSBOROUGH	M AH G Z B ER OW
WOODBRIDGE  W UH D B R IH JH
CHALON	CH AE L AH N
CUTTERS  K AH T ER Z
ACTUATE  AE K CH UW EY T
INVOLVING  IH N V AA L V IH NG
CLIFFORD  K L IH F ER D
PREDAL	P R EH D AH L
TUBERS	T UW B ER Z
HISSEN	HH IH S AH N
HATCHES  HH AE CH IH Z
KALIKO	K AE L IH K OW
EMPHATICALLY  EH M F AE T IH K L IY
DIEULET	D UW L IH T
MARPL	M AA R P AH L
INHABITENTS	IH N HH AE B AH T EH N T S
ACCOUNTABILITY  AH K AW N AH B IH L IH T IY
ANNOS	AE N OW Z
PASTILES	P AE S T AY L Z
AKELA	AH K EH L AH
HARDRAT'S	HH AA R D R AE T S
BLONDIE  B L AA N D IY
CATESBY	K EY T S B IY
MAMORE	M AA M AO R
AUBIERS	AO B IY ER Z
POSITS  P AA Z AH T S
COTTONADE	K AA T AH N EY D
FANHALL	F AE N HH AH L
PURPOSELESSNESS	P ER P AH S L AH S N AH S
ASCENDANCY  AH S EH N D AH N S IY
SIPA  S IY P AH
DRUMTOCHTY	D R AH M T AH K T IY
JAZZED  JH AE Z D
HARPAR	HH AA R P AA R
MIGUEV	M IY G EH V
ERGASTE	ER G AH S T
CHURNIN	CH ER N IH N
RECORDERS  R IY K AO R D ER Z
BROOCH  B R UW CH
TA'	T AA
VALPINSON	V AO L P IH N S AH N
REPLENISH'D	R IY P L EH N IH SH D
LAWDY	L AO D IY
LUMINOT'S	L UW M IH N OW Z
POTHECARY	P AA TH AH K EH R IY
CANTOR  K AE N T ER
ORSINI  AO R S IY N IY
RIGG'D	R IH G D
LORTON'S	L AO R T AH N Z
REPROVE	R IY P R UW V
IRRELEVANT  IH R EH L AH V AH N T
FICINUS	F IH S IY N AH S
NOMINALISM	N AA M AH N AH L IH Z AH M
ESTER  EH S T ER
RESONANCES	R EH Z AH N AH N S IH Z
FRUCTIFIES	F R AH K T AH F AY Z
BENAS	B EH N AH S
MANNEQUIN  M AE N AH K IH N
UNDULLED	AH N D AH L D
HARMAR	HH AA R M AA R
HARPSTRING	HH AA R P S T R IH NG
DETERIORATIONS	D IH T IH R IY ER EY SH AH N Z
PAGED  P EY JH D
ACCELERATOR  AE K S EH L ER EY T ER
RAMPION	R AE M P IY AH N
GLOWER  G L AW ER
NASTASIO	N AA S T AA S IY OW
SLAYBACK'S	S L EY B AE K S
INCORRUPTIBILITY	IH N K ER AH P T AH B IH L AH T IY
PADRIAC	P AE D R IY AE K
CULLIS	K AH L IH S
BISHOPSGATE  B IH SH AH P S G EY T
ORANGERIE	AO R AH N JH ER IY
DRUSIE  D R AH S IY
FERRARESE	F ER AA R EY Z IY
ROOSHAN	R UW SH AH N
D'HISTOIRE	D AH S T W AA R
YAVI	Y AE V IY
ANNCHEN	AH N CH AH N
BLAGDON	B L AE G D AH N
PLYMOUTH'S  P L IH M AH TH S
NOONIN	N UW N IH N
PLAYGROUND  P L EY G R AW N
BENTIVOGLIO	B EH N T IY V OW L Y OW
UNMOISTENED	AH N M OY S AH N D
POPPIE'S	P AA P IY Z
D'EVREUX	D AH V ER OW
INCONVENIENCE  IH N K AH N V IY N Y AH N S
REPRESSING  R IY P R EH S IH NG
LOATHLY	L OW TH L IY
STALHAM	S T AO L HH AH M
ISAURA'S	AY S AO R AH Z
DOWNFALL  D AW N F AO L
LUMANO	L UW M AA N OW
MATURATION  M AE CH UH R EY SH AH N
DREAMED  D R IY M D
NOTEPAD	N OW T P AE D
AMATEUR'S	AE M AH CH ER Z
KENNEL  K EH N AH L
MONEYED  M AH N IY D
DIPSEY	D IH P S IY
GRINGO'S	G R IH NG G OW Z
INCONSISTENCE	IH N K AH N S IH S T AH N S
MULHAUS	M AH L HH AW S
DIAGORAS	D AY AH G AO R AH Z
HONNOR	HH AA N ER
GILLIN  G IH L IH N
ASTOUNDS  AH S T AW N D Z
PINO  P IY N OW
DICTATING  D IH K T EY T IH NG
ALLEE'S	AH L IY Z
NOTS  N AA T S
RAGWEED  R AE G W IY D
TODAR	T OW D AA R
SPRINGFIELD  S P R IH NG F IY L D
LEWS	L UW Z
UKONONGO	Y UW K AH N AO NG G OW
DREAULOND	D R UW L AH N D
KNEEL  N IY L
ROSAMUND'S	R OW Z AH M UH N D Z
MERVYNS	M ER V IH N Z
BEWITCHMENTS	B IH W IH CH M AH N T S
CONVERS	K AA N V ER Z
COCHRAN  K AA K R AH N
INTERDICTION  IH N T ER D IH K SH AH N
MAIGNAN'S	M EH N Y AH N Z
REFRACTIONS	R AH F R AE K SH AH N Z
FIORIMONDE	F IY AO R IH M AA N D
WAE'S	W AA Z
SPLITTING  S P L IH T IH NG
EMBARCATION	EH M B AA R K EY SH AH N
NUCKY'S	N AH K IY Z
FROWNED  F R AW N D
LILJECRONA	L IH L JH IH K R OW N AH
FUNDA	F AH N D AH
THUNK  TH AH N K
HALLELUIAH	HH AE L AH L UW AH
VISITINGS	V IH Z IH T IH NG Z
COURBASH	K UH R B AE SH
REX  R EH K S
CORNFORD	K AO R N F ER D
STAWELL	S T AE W EH L
RECIPROCITY  R EH S IH P R AA S IH T IY
REDDON	R EH D AH N
PELONE	P EH L OW N IY
ABRUPTLY  AH B R AH P T L IY
ALTERUM	AO L T EH R AH M
APRICOTS  AE P R AH K AA T S
SEAMSTRESS  S IY M S T R IH S
ARLIE  AA R L IY
MINORITE  M IH N ER AY T
NEWMARK  N UW M AA R K
HARPED  HH AA R P T
OCCIDENT  AA K S AH D EH N T
SHEEPDOGS	SH IY P D AO G Z
BURMA  B ER M AH
DISREPUTATION	D IH S R EH P Y AH T EY SH AH N
NAMGAY	N AE M G EY
QUINTIN  K W IH N T IH N
DISTINGUISHING  D IH S T IH NG G W IH SH IH NG
GRICHKA	G R IH CH K AH
CSANTA	Z AA N T AH
AVIDLY  AE V AH D L IY
KERNEGUY	K ER N AH G AY
BELTHORP	B EH L TH AO R P
SUNARIO	S AH N EH R IY OW
BONIFAZIO	B AA N IH F EY Z IY OW
KAZEDKY	K AH Z EH D K IY
SLYME'S	S L AY M Z
TELEPHONIN	T EH L AH F OW N IH N
STRUGGLER	S T R AH G AH L ER
FERN  F ER N
DUNKE	D AH NG K
UNDYING  AH N D AY IH NG
BICYCLE  B AY S IH K AH L
ATTENUATED  AH T EH N Y UW EY T IH D
MAELER	M EY L ER
SIEVES  S IH V Z
HOCK  HH AA K
SECTIONARIES	S EH K SH AH N EH R IY Z
SUPPLEMENTAL  S AH P L AH M EH N T AH L
EMBOLDENED  EH M B OW L D AH N D
LAVATER'S	L AE V AH T ER Z
CAHORS	K AH HH ER Z
UNCIRCUMCISION	AH N S ER K AH M S IH ZH AH N
UPROSE	AH P R OW Z
BARITONE  B EH R AH T OW N
RESONANT  R EH Z AH N AH N T
TUNNELLED	T AH N AH L D
DOUBLEDAY'S	D AH B AH L D EY Z
EVEH	AH V AH
WINMARLEIGH	W IH N M AA R L AH
OIRISH	OY R IH SH
POMMER  P AA M ER
PLANCHET	P L AE N K IH T
HEURNE	HH Y UH R N
BEHIN	B EH HH IH N
PENIS  P IY N IH S
GENSERIC'S	G EH N S EH R IH K S
ADVOCATED  AE D V AH K EY T IH D
VIMIERA	V AY M IY R AH
COMPATRIOTES	K AH M P EY T R IY AH T S
HORNWORK	HH AO R N W ER K
KOVALOFF	K AH V AA L AO F
GHOUL  G UW L
ROSANNE  R OW Z AE N
SHEEPY	SH IY P IY
PAPPENHEIMERS	P AE P AH N HH AY M ER Z
PIGNUT	P IY G N AH T
DRAYNE'S	D R EY N Z
MACOUBA	M AH K UW B AH
REORIENTATION	R IY AO R IY EH N T EY SH AH N
DEADERS	D EH D ER Z
SILENCE  S AY L AH N S
MOTTKA	M AA T K AH
DIRECTIONS  D IY R EH K SH IH N Z
JAPONEL	JH AH P AA N AH L
EMBROIDERING  EH M B R OY D ER IH NG
MIXTURES  M IH K S CH ER Z
MILES  M AY L Z
TIMGAD	T IH M G AA D
COLUMBINE'S	K AA L AH M B AY N Z
FERRATI	F ER AA T IY
WOIVODE	W OY V OW D
POPAYAN	P AA P EY AH N
BRAGGART'S	B R AE G ER T S
OTTOMANISATION	AA T AH M AH N IH Z EY SH AH N
DILUTED  D AY L UW T AH D
DEVENANT	D EH V IH N AH N T
B'ILER	B AH AY L ER
OUTSTEP	AW T S T EH P
SKILLION	S K IH L Y AH N
SELINOUS	S EH L IH N AH S
PASQUALE  P AA S K W AA L EY
MANIPULATION  M AH N IH P Y AH L EY SH AH N
MORAUX	M ER AO K S
VULGARE	V AH L G EH R
BARLINGFORD	B AA R L IH NG F ER D
JACQUELINA'S	JH AE K W AH L IY N AH Z
ENSNARING	IH N S N EH R IH NG
GIGADIBS	G IH G AH D IH B Z
GLAMORGAN'S	G L AE M ER G AH N Z
BEFOGS	B IH F AO G Z
YAWCOB	Y AO K AH B
WASHHOUSE	W AA SH HH AW S
BARNABAS  B AA R N AH B AH S
TREACHERIES	T R EH CH ER IY Z
RONSARD	R AA N S ER D
MORAKANABAD	M AO R AA K AA N AH B AE D
GONDOLA  G AA N D OW L AH
WEALLY	W IY L IY
PARADED  P ER EY D IH D
LAUNCE	L AO N S
HANAK  HH AA N AH K
IMPOVERISHED  IH M P AA V R IH SH T
DONNELLY'S  D AA N AH L IY Z
NAUSEATINGLY	N AO Z IY EY T IH NG L IY
TEAM'S  T IY M Z
SCIOLISM	S AY AH L IH Z AH M
EVIE'S	EH V IY Z
GRANDMAISON  G R AE N D M EY S AH N
CONFECTIONS  K AH N F EH K SH AH N Z
STIGMA  S T IH G M AH
GLISTENS	G L IH S AH N Z
TOUSSAC	T UW S AE K
LABANOFF	L AA B AE N AO F
KUEHLEBORN	K UH L B ER N
DINKIE'S	D IH NG K IY Z
FURGIT	F ER G IH T
CRITICIZED  K R IH T AH S AY Z D
GOETZE  G OW T Z
INSECT  IH N S EH K T
AUDEMER	AO D IY M ER
COCHITUATE	K OW CH IH CH UW EY T
EXEMPLARY  IH G Z EH M P L ER IY
ABDIN	AE B D AH N
BURYIN	B EH R IY IH N
HAMMURABI'S	HH AE M UH R AA B IY Z
WEIHE  W IY HH
ALAMANCE  AE L AH M AE N S
CLEMATIS  K L AH M AE T IH S
PENITENTE	P EH N IH T IH N T
UNTILLED	AH N T IH L D
CHAMPIONING  CH AE M P IY AH N IH NG
SHUFFLER  SH AH F L ER
LENIN  L EH N AH N
MEDUSE	M AH D UW S
MOONEY  M UW N IY
SLUNG  S L AH NG
CONDUCT  K AA N D AH K T
ARCHARD  AA R SH AA R D
MARKO  M AA R K OW
FRIESSHARDT	F R IY S HH AA R T
SKARPHEDINN	S K AA R F AH D IH N
SIMMERING  S IH M ER IH NG
MAAM  M AH M
FLECKING	F L EH K IH NG
CULLERTON  K AH L ER T AH N
OPTIONAL  AA P SH AH N AH L
DISRESPECT  D IH S R IH S P EH K T
JEWELRY  JH UW L ER IY
VANDERVEER  V AE N D ER V IH R
STRETCHING  S T R EH CH IH NG
KLEAGLES	K L IY G AH L Z
EXPOSIN	EH K S P AH Z IY N
RAYNIER	R EY N IY ER
CESARE  CH EY Z AA R EY
QUINT  K W IH N T
OHIYESA	OW HH IY EH S AH
JOVANNI	JH OW V AA N IY
SMIKE	S M AY K
CERTAINTY  S ER T AH N T IY
MISTING	M IH S T IH NG
RAZOR'S  R EY Z ER Z
GRIFFIN  G R IH F IH N
TIMOA	T IH M OW AH
INTU	IH N T UW
WAILO	W AY L OW
MONASTERIES  M AA N AH S T EH R IY Z
FRANZ'S	F R AA N Z IH Z
VERNOCQ	V ER N AH K
DRAVE	D R EY V
DEVINES	D AH V AY N Z
GAUL  G AO L
FILLSON	F IH L S AH N
SPRINTERS  S P R IH N T ER Z
COLLEAGUE  K AA L IY G
GAIRE	G EH R
ABY'S	EY B IY Z
BARGAININGS	B AA R G IH N IH NG Z
ORION  AO R AY AH N
VINCENT'S  V IH N S IH N T S
RACKING  R AE K IH NG
GRAZED  G R EY Z D
CURSIN	K ER S IH N
LOYAUTE	L OY OW T
COUNTRYWOMAN	K AH N T R IY W UH M AH N
ALPINE'S	AE L P AY N Z
HASHEESH	HH AH SH IY SH
PARABOLICALLY	P EH R AH B AA L IH K L IY
BEERSHEBA	B IH R SH IY B AH
DEVICES  D IH V AY S IH Z
SERGINT	S EH R JH IY N T
TUERI	T W EH R IY
CRESCENT'S	K R EH S AH N T S
TALA	T AA L AH
PARERGA	P ER EH R G AH
BRICKING	B R IH K IH NG
META'S	M EH T AH Z
PRAECOX	P R IY K AA K S
SIHAMBA	S IY HH AA M B AH
WIDEGABLES	W AY D AH G AH B AH L Z
CHIE	CH IY
BUGABOOS	B AH G AH B UW Z
ATAUNTO	AH T AA N T OW
MARCHANT  M AA R CH AH N T
RECRUIT  R IH K R UW T
WANTAGE'S	W AA N T IH JH IH Z
TRUSTS  T R AH S T S
DARDANELLES	D AA R D AH N EH L Z
MORISON  M AO R IH S AH N
IYER  AY ER
CHARIKAR	CH EH R IH K AA R
JACI	JH AA CH IY
HEDONISTS	HH IY D AH N IH S T S
NAM'D	N AE M D
PUAH	P UW AA
ROMANTICISTS	R OW M AE N T IH S IH S T S
PITCAIRN'S	P IH T K EH R N Z
SAVELLO	S AH V EH L OW
CALLOSITIES	K AE L AA S AH T IY Z
Y'SEE	Y S IY
TILTINGS	T IH L T IH NG Z
WACHTMANN	W AO K T M AH N
BALLANTRAE  B AE L AH N T R EY
COWLEY  K AW L IY
FEDELMA	F EH D EH L M AH
LAYLOCK	L EY L AH K
ATUONA	AE CH UW OW N AH
DENGUE  D EH N G
VISP	V IH S P
REGNUM	R EH G N AH M
OUTJUMP	AW T JH AH M P
PRESARVE	P R IH S AA R V
AUBERTIN	AO B ER T IY N
RESIDENTIAL  R EH Z IH D EH N CH AH L
BRODERSON  B R AA D ER S AH N
SAGOSTO	S AA G OW S T OW
PRETENSES  P R IY T EH N S IH Z
SUFFERED  S AH F ER D
ZEALANDER  Z IY L AH N D ER
STAKIN	S T EY K IH N
EVERIE	EH V ER IY
HARVIE  HH AA R V IY
COMMANDOS  K AH M AE N D OW Z
IDRES	IH D R EY Z
FIDGETT	F IH JH IH T
TOFOA	T OW F OW AH
BILLIARD  B IH L Y ER D
BEL  B EH L
DESIDERIA	D IH S IY D EH R IY AH
WINDGALL	W IH N D G AH L
HOGGINS	HH AA G IH N Z
TROTSKY'S	T R AA T S K IY Z
OPPOSITE  AA P AH Z AH T
DOTAGE	D OW T AH JH
HALFDAN  HH AE L F D AH N
DRINKINGS	D R IH NG K IH NG Z
SINFONIA  S IH N F OW N IY AH
DENECKER	D EH N IH K ER
PLAYDAY	P L EY D EY
MAMATEE	M AA M AH T IY
COVINGTON'S	K AH V IH NG T AH N Z
TRAFTON'S	T R AE F T AH N Z
STROOK	S T R UH K
MULTICOLOURED	M AH L T IY K AH L ER D
CROISSET'S	K W AA S EH T S
STUBBY'S	S T AH B IY Z
FAILIN	F EY L IH N
FAIDH	F EY D
SNIPS  S N IH P S
SOMEBODY'S  S AH M B AA D IY Z
VINCENZO'S	V IY N CH EH N Z OW Z
ADAPTABLE  AH D AE P T AH B AH L
F'M	EH F M
SCHIRR	SH ER
LAIRS	L EH R Z
GAVEGAN	G AH V EH G AH N
OOSE	UW S
POULARD	P UW L AA R D
NOVALIS	N OW V AA L IY Z
D'HYMBERCOURT	D AH M ER K AO R T
EMDEN'S	EH M D AH N Z
PAJAMAS  P AH JH AA M AH Z
MANNINGLEA	M AE N IH NG L IY
KANGWE	K AE NG W
ORIGINATION  ER IH JH AH N EY SH AH N
CEREMONY  S EH R AH M OW N IY
VAUGHAN'S  V AO N Z
JULY  JH AH L AY
CAPRAJA	K AA P R AA JH AH
KEH	K EH
LUDWIG'S	L AH D W IH G Z
STARNS  S T AA R N Z
PLOWDEN  P L AW D AH N
GOBERNADOR	G OW B ER N AH D AO R
SUPERVISORS  S UW P ER V AY Z ER Z
DIFF'ENCE	D IH F AH N S
COTERIES	K OW T ER IY Z
CARNIFEX	K AA R N IH F EH K S
CAMOUFLAGE  K AE M AH F L AA ZH
AGAR  EY G ER
DEFENDU	D IH F EH N D UW
ANATOMIZED	AH N AE T AH M AY Z D
CURTEST	K ER T AH S T
FUSTINESS	F AH S T IY N AH S
WADING  W EY D IH NG
GAILLARDE	G EY L AA R D IY
FORBACH	F AO R B AA K
MOXIE  M AA K S IY
MASKEW'S	M AE S K Y UW Z
PECULATIONS	P EH K Y AH L EY SH AH N Z
BROWNSTONE  B R AW N S T OW N
POCOMOKE	P OW K AH M OW K
ALERT  AH L ER T
UNANSWERED  AH N AE N S ER D
HORTICULTURAL  HH AO R T AH K AH L CH ER AH L
CRESCENCE	K R EH S AH N S
PLACED  P L EY S T
EXTORT  EH K S T AO R T
FROZE  F R OW Z
TICULA	T IH K Y AH L AH
MARTYRED  M AA R T ER D
SINGLET	S IH NG G AH L T
FORGIVES  F ER G IH V Z
YUTAS	Y UW T AA Z
OBSTRUCTIVE  AH B S T R AH K T IH V
MNEMOSYNE	N IH M AA S AY N
FORWARDING  F AO R W ER D IH NG
LUGG	L AH G
MALENA  M AE L IH N AH
MIDDY'S	M IH D IY Z
SEEGAIRS	S IY G EH R Z
OUTRIVALS	AW T R AY V AH L Z
INFLATES  IH N F L EY T S
DOGRIB	D AO G R IH B
AUGHEY	AH G EY
FACTORS  F AE K T ER Z
DISLOYALTY  D IH S L OY AH L T IY
LINACRE	L AY N IH K ER
HEC	HH EH K
DOCKYARDS	D AA K Y AA R D Z
JUSQU'ICI	Y UW S K IY CH IY
FRINCHMAN	F R IH NG K M AH N
CARMODY'S	K AA R M AH D IY Z
COCAGNE	K OW K EY N Y
CANONISATION	K AE N AH N IH Z EY SH AH N
EANSWYTH'S	IY N Z W IH TH S
L'OUVERTURE	L AO V ER CH ER
DEED'S	D IY D Z
MESROUR	M EY R AO R
BROSS  B R AO S
YESTREEN	Y EH S T R IY N
OVERTHREW  OW V ER TH R UW
MUZIO  M Y UW Z IY OW
PERFORATED  P ER F ER EY T IH D
WELDED  W EH L D IH D
FREDERIK	F R EH D ER IH K
SOBERLY  S OW B ER L IY
PEDDLING  P EH D AH L IH NG
STACKPOLE  S T AE K P OW L
GUNNLOED	G AH N L OW D
GYARD	G Y AA R D
DARROW  D EH R OW
OSSERVATORE	AA S ER V AH T AO R
DAWGS	D AO G Z
ATLANS	AE T L AE N Z
HOANGTI	HH OW NG K T IY
CAGOT	K AE G AH T
HISI	HH IH S IY
GWINEEBOO	G W IH N IH B UW
BLUEBOTTLES  B L UW B AO T AH L Z
LITEM  L IY T EH M
TOURNAMENTS  T ER N AH M AH N T S
SUITINGS	S UW T IH NG Z
BETIDED	B IH T AY D IH D
KIDDIE'S	K IH D IY Z
RODES  R OW D Z
DIVERSA	D IH V ER S AH
TINGA	T IH NG G AH
GABIE  G AE B IY
OXBYE	AA K S B AY
CLINCH  K L IH N CH
ATHEIST  EY TH IY AH S T
MISCONDUCTING	M IH S K AH N D AH K T IH NG
TRIPP'S  T R IH P S
LEGGINGS  L EH G IH NG Z
OFTENER  AO F T AH N ER
NINETIES  N AY N T IY Z
LURAY	L UH R EY
DOSY	D OW S IY
DICTATORSHIPS  D IH K T EY T ER SH IH P S
MAGAREY	M AA G AE R IY
STEDBURGH	S T EH D B ER G
KAKEMONO	K AA K EY M OW N OW
WELFORD  W EH L F ER D
LITTLEWOOD  L IH T AH L W UH D
CONSTRAINEDLY	K AH N S T R EY N D L IY
PRETORIAN	P R IY T AO R IY AH N
WHEREAWAY	W EH R AH W EY
FORRID	F AO R AH D
PED	P T
FELICITY'S	F IH L IH S AH T IY Z
STATIONER  S T EY SH AH N ER
CHARACTERIZING  K EH R IH K T ER AY Z IH NG
SYPHOGRANTS	S IH F AA G R AH N T S
MECHINET	M EH CH IH N EH T
FANG  F AE NG
KORY  K AO R IY
FLOP  F L AA P
RUDD'S	R AH D Z
PAPERARELLO	P AE P AH R AA R EH L OW
RHODA  R OW D AH
MOUF	M OW F
LUTCHES	L AH CH IH Z
ROUSSELET  R UW S AH L EH T
INAUDIBLY  IH N AO D AH B L IY
GUENEVER	G IH N EH V ER
FESTERING  F EH S T ER IH NG
DISHONORABLY	D IH S AA N ER AH B L IY
DALQUHARTER	D AE L K AA R T ER
FANN'D	F AE N D
SPLINTERY  S P L IH N T ER IY
CRITICISE	K R IH T IH S AY Z
EBBINGS	EH B IH NG Z
SCARPS	S K AA R P S
MERKELL	M ER K AH L
KIRKSTALL	K ER K S T AH L
BONI  B OW N IY
AUGUSTUS'S	AH G AH S T AH S IH Z
NORWEGIAN  N AO R W IY JH AH N
AKOULINA	AH K UW L IY N AH
MICROPHYLLA	M AY K R OW F IH L AH
SNITCH  S N IH CH
ALVIRY	AE L V AY R IY
PAKRIAA'S	P AE K R IY AH Z
MORALIST  M AO R AH L IH S T
KRAYBO	K R EY B OW
CONVULS'D	K AH N V AH L SH D
WHITNEY  HH W IH T N IY
BEHOLDER'S	B IH HH OW L D ER Z
OUTNESS	AW T N AH S
KADDISH	K AE D IH SH
GARNISH'D	G AA R N IH SH D
POACHERS  P OW CH ER Z
WICKWIRE  V IH S K V AY R
HUGONIN	HH AH G AH N IH N
COLLIN'S	K AA L IH N Z
BOMPAS	B AA M P AH S
SENDED	S EH N D IH D
MORYNSKA	M AO R IH N S K AH
WYNKYN	W IH NG K IH N
LIBYAN  L IH B IY AH N
PARCELED  P AA R S AH L D
SHILLELAH	SH IH L IH L AH
CONFUTATION	K AH N F Y UW T EY SH AH N
OLA  OW L AH
DUSENALL	D UW S AH N AA L
LOTHIANS	L AA TH IY AH N Z
TARLAC'S	T AA R L AE K S
TUBBY'S	T AH B IY Z
QUIBIAN	K W IH B IY AH N
JUBEI	JH UW B AY
BLATHERIN	B L AE DH ER IH N
CAAN'T	K AA N T
GISQUET	G IH S K EY
BENEFICENCES	B EH N AH F IH SH AH N S IH Z
TORONE	T AO R AH N
ENKINDLE	EH N K AY N D AH L
THALASSIUS	TH AE L AH S IY IH S
MOUTHFULS	M AW TH F UH L Z
URMSING	ER M Z IH NG
DUCS	D AH K S
SALYERS  S AA L IY ER Z
PILLBODY	P IH L B AA D IY
CORRELATE  K AO R AH L AH T
SARWAK	S AA R W AA K
CRAWSHAY	K R AO SH EY
SHADY  SH EY D IY
BLUSTERERS	B L AH S T ER ER Z
SIDDON	S IH D AH N
STANCHION	S T AE N CH IY N
IRATE  AY R EY T
TOOTHPASTE  T UW TH P EY S T
APOLLONIAN  AE P AH L OW N IY AH N
ROCKHAVEN	R AA K HH EY V AH N
TUSSLED  T AH S AH L D
PROCLAMATION  P R AA K L AH M EY SH AH N
MOSEYED	M OW Z IY D
L'ILE	L AY L
AEMILIANUS	EY M IH L IY AE N AH S
GREENWOOD  G R IY N W UH D
FLUXION	F L AH K SH AH N
MELLICENT  M EY L IY S AH N T
SALMON'S	S AE M AH N Z
DAVOS  D AA V OW S
MEURTRIER	M ER T ER IY ER
MONTAUBAN	M OW N T AA UW B AH N
GARPLE	G AA R P AH L
PUKING	P Y UW K IH NG
SOIGHT	S OY T
RESPIRATIONS	R EH S P ER EY SH AH N Z
STIGANDI	S T IH G AH N D IY
ARSENATE	AA R S AH N EY T
ASBYTE	AH S B AY T
EXPLAININGS	IH K S P L EY N IH NG Z
PUGILISM  P Y UW JH AH L IH Z AH M
DISH  D IH SH
IGHER	AY ER
MORTLAND  M AO R T L AH N D
DUNDONALD	D AH N D AA N AH L D
EXACERBATING  IH G Z AE S ER B EY T IH NG
CODMAN	K AA D M AH N
PAULCHEN	P AO L CH AH N
POTASSIUM  P AH T AE S IY AH M
GOOMTEE	G UW M T IY
ACHIEVEMENT  AH CH IY V M AH N T
JOVIAN'S	JH OW V IY AH N Z
QUELCHIES	K W EH L CH IY Z
WALTZER  W AO L T S ER
NEIGHBOURLY	N EY B ER L IY
HENDERSONS	HH EH N D ER S AH N Z
VAIREE	V EY R IY
JOERGEL	JH AO R G AH L
LURETTA'S	L ER EH T AH Z
CROTCHES	K R AA CH IH Z
CONTINUES  K AH N T IH N Y UW Z
SWITCHBACK	S W IH CH B AE K
SUBDEAN	S AH B D IY AH N
CASUISTICAL	K AE ZH W IH S T IH K AH L
RESOLUTIONS  R EH Z AH L UW SH AH N Z
CONFEDERATES	K AH N F EH D ER AH T S
RODOSTO	R OW D AA S T OW
SUFFIELD  S AH F IY L D
SEPTUAGENARIAN  S EH P CH UW AH JH AH N EH R IY AH N
DRISCOL	D R IH S K AA L
TRUMET	T R AH M IH T
EMULSIONS	IH M AH L SH AH N Z
VAPOROUS	V EY P ER AH S
POKNEES	P AA N IY Z
RIKKI  R IH K IY
STRICK  S T R IH K
GREENLY  G R IY N L IY
POSTAGE  P OW S T IH JH
BYNOE  B IH N OW
THANKSGIVING  TH AE NG K S G IH V IH NG
CARET	K EH R T
MIKSZATH	M IH K Z AE TH
UNMITIGATED  AH N M IH T AH G EY T IH D
SERRATIONS	S ER EY SH AH N Z
HA'NTING	HH AH N IH NG
SAJ	S AY
FORAYS  F AO R EY Z
GRENWITZ	G R EH N W IH T S
JUDG	JH AH JH
KRAPF  K R AE P F
SATURDAY  S AE T IH D EY
BOUNCERS  B AW N S ER Z
PAROIT	P AA R OY T
SEISMIC  S AY Z M IH K
RAVISHINGLY	R AE V IH SH IH NG L IY
RETICULE	R EH T AH K Y UW L
DISBURDENING	D IH S B ER D AH N IH NG
TRIDDELSITZ	T R IH D AH L S IH T S
KROTEN	K R OW T AH N
SLAV'RY	S L AA V R IY
BARCLAY'S  B AA R K L EY Z
UNPLANED	AH N P L EY N D
BUDLONG'S	B AH D L AO NG Z
SAYING  S EY IH NG
NORLAMIN	N AO R L AH M AH N
FRISIO'S	F R IH S IY OW Z
UNEXPLAINABLY	AH N IH K S P L EY N AH B L IY
D'ORSI	D AO R S IY
INDUCT  IH N D AH K T
MIMETIC	M IH M EH T IH K
NUDGES  N AH JH IH Z
SOUNDED  S AW N D AH D
SILWOOD'S	S IH L W UH D Z
MULGARS	M AH L G ER Z
GROOS  G R UW Z
KNYPE	N AY P
GEN'LEMAN	JH EH N AH L M AH N
DISMANTLE  D IH S M AE N AH L
REINTERPRETED  R IY IH N T ER P R AH T IH D
KOODI	K UW D IY
ADET'S	AH D EH T S
CASSAGNAC	K AA S AA N Y AE K
COBRA'S	K OW B R AH Z
CROIZETTE	K R AH Z EH T
PONZIANO	P AA N Z IY AA N OW
COUDRAI	K UW D R EY
ZAPORA	Z AA P AO R AH
HINCKS	HH IH NG K S
REPEAT  R IH P IY T
FARWELL  F AA R W EH L
BOMBYANE	B AA M AY AE N
CHARLY	CH AA R L IY
DRAWSTRING	D R AO S T R IH NG
SHAREHOLDERS  SH EH R HH OW L D ER Z
VARDIN	V AA R D IH N
GARRED	G AA R D
ADJOURN  AH JH ER N
VICTORINO  V IY K T AO R IY N OW
PANDALEVSKY	P AE N D AH L EH V S K IY
CAVENDISH'S	K AE V AH N D IH SH IH Z
CORNEA  K AO R N IY AH
ABOEZA	AH B EY Z AH
DUENNA	D UW EH N AH
JUAM	HH W AA M
GOOGAGOO'S	G UW G AH G UW Z
CHILENO	CH IH L EY N OW
SENSUALITY  S EH N SH UW AE L AH T IY
CONGERIES	K AA NG G ER IY Z
SIDEWARD	S AY D W ER D
GRASP'D	G R AE S P D
FRADE	F R EY D
HARVESTED  HH AA R V AH S T IH D
SAAY	S EY
CHUBBS	CH AH B Z
UNDERMINES  AH N D ER M AY N Z
GAWKS	G AO K S
DAKERS	D EY K ER Z
BOABDIL'S	B OW AE B D AH L Z
EUS	Y UW Z
THAN  DH AE N
MESTIZO  M EH S T IY Z OW
WRETCHES	R EH CH IH Z
CONTAIN'D	K AH N T EY N D
CRUMPLED  K R AH M P AH L D
CHAUNCE  CH AO N S
RODENSTEIN	R OW D AH N S T AY N
CAMPEGGIO	K AA M P EH JH IY OW
VAISHNAVS	V EY SH N AH V Z
BOSUN'S	B AA S AH N Z
PERKINSES	P ER K IH N S IH Z
DICKSEE	D IH K S IY
WILLIS'S  W IH L IH S IH Z
GARIGLIANO	G ER IY G L IY AA N OW
MARIENBAD	M EH R IY N B AE D
BLUDIRON	B L AH D AY ER N
NARABANCHI	N AA R AA B AA N CH IY
ORDERED  AO R D ER D
TAMASP	T AA M AA S P
HOHENZOLLERNS	HH OW AH N Z AA L ER N Z
MORDEN'S	M AO R D AH N Z
HERDERS  HH ER D ER Z
VERDERER	V ER D ER ER
NANDA	N AA N D AH
LOGOI	L OW G OW IY
ROENTGEN'S	R OW N T G AH N Z
FROGMEN  F R AA G M IH N
CONSTANTINA  K AA N S T AA N T IY N AH
KALONYMOS	K AE L AH N IH M OW Z
SLAVIC  S L AA V IH K
LAPTITZA	L AE P T IH T Z AH
TURBULENCE  T ER B Y AH L AH N S
SCHUL  SH UH L
THURZO	TH ER Z OW
YESTERYEAR  Y EH S T ER Y IH R
GULF'S  G AH L F S
FENLANDS	F EH N L AE N D Z
CLASPS	K L AE S P S
GESA	JH EH S AH
DALRYMPLES	D AE L R IH M P AH L Z
O'BRADY	OW B R EY D IY
UNSUITED  AH N S UW T IH D
DROMOS	D R OW M OW Z
KIRKLAND  K ER K L AH N D
NAOMI  N EY OW M IY
FIGURIN	F IH G Y ER IH N
CLAMPED  K L AE M P T
MELAR	M EH L AA R
DAHCOTAH	D AA K OW T AA
LOATHSOME  L OW TH S AH M
GRAFTS  G R AE F T S
BOSINNEY'S	B OW S IH N IY Z
VENIZELOS	V EH N AH Z AH L OW Z
PIEN	P IY N
BEMOANS  B IH M OW N Z
LICET	L AY S AH T
GREC	G R EH K
DOCHART	D AA K HH AA R T
NIGHTJAR	N AY T AH Y AA R
MAHOUT	M AE HH AW T
JACOMINA	JH AE K AH M IY N AH
THORNLEIGH	TH AO R N L AH
VEINS  V EY N Z
INTERSTATE  IH N T ER S T EY T
ZARAILA	Z AA R AA IY L AH
PROJECTS  P R AH JH EH K T S
ACRE  EY K ER
FORTUNEE	F AO R CH AH N IY
LOW'D	L AW D
SABLOUKOFF	S AH B L AW K AO F
BRUENNHILDE	B R UW N HH IH L D
LENIENT  L IY N Y AH N T
D'ANDELOT	D AE N D IH L AA T
NINIB	N AY N IH B
WIMPLING	W IH M P L IH NG
GUDEHART	G UW D AH HH AA R T
BEMOANED  B IH M OW N D
GENLIS	JH EH N L IH S
KRIJGSRAAD	K R IH JH Z R AA D
PAUVRETTE	P OW V R EH T
GATTON'S	G AE T AH N Z
MAYORUNAS	M EY ER UW N AH Z
QUERE	K W IY R
THURSDALE	TH ER Z D EY L
ARISTE	AA R IH S T
HAZLITT	HH AE Z L IH T
BENTIVOGLI	B EH N T IY V AA G L IY
LOWELLS	L OW AH L Z
PARKY	P AA R K IY
SHAKU	SH AA K UW
STANNIN	S T AE N IH N
DROMON  D R OW M AH N
HOARE  HH AO R
ARMORICA	AA R M ER IY K AH
AZITO	AH Z IY T OW
VIKINGS  V AY K IH NG Z
ADELSBERG	AE D IH L Z B ER G
BACKWASH  B AE K W AA SH
HIN	HH IH N
JAMI  JH EY M IY
WISTER'S	W IH S T ER Z
HONORA  AO N AO R AH
HENNIE	HH EH N IY
KINGSLEY  K IH NG Z L IY
POLYPS  P AA L IH P S
SOMERSAULTED	S AH M ER S AO L T IH D
TORKIN	T AO R K IH N
BONSECOURS	B AA N S AH K AO R S
QUIDNUNCS	K W IH D N AH NG K S
LAVVY'S	L AE V IY Z
FAMILIAR  F AH M IH L Y ER
INVESTIGATED  IH N V EH S T AH G EY T IH D
ACCORAMBONI	AH K AO R AE M B OW N IY
APPENDICITIS  AH P EH N D IH S AY T IH Z
VERPLANCK'S	V ER P L AE NG K S
SCANDAL'S  S K AE N D AH L Z
ANOMALOUSLY	AH N AA M AH L AH S L IY
NEWS  N Y UW Z
WOODPIGEON	W UH D P IH JH AH N
SALT  S AO L T
INTERVIEWED  IH N T ER V Y UW D
SHOTLEY	SH AA T L IY
DISCERNMENTS	D IH S ER N M AH N T S
VARSOVIE	V AA R S AH V IY
TRUDI	T R UW D IY
ERCOLE  ER K OW L IY
MASTERLY  M AE S T ER L IY
ACETYLENE  AH S EH T AH L IY N
USHER'S	AH SH ER Z
WHILED	W AY L D
ANTINAHUEL	AE N T AH N AH Y UW L
LIDGERWOOD  L IH JH ER W UH D
CRALINE	K R AA L IY N IY
SOPHISTICAL	S AH F IH S T IH K AH L
STEWARTS	S T UW ER T S
IMPRESSIVE  IH M P R EH S IH V
POSTHUMIUS	P AA S CH UH M IY IH S
SHALLOWING	SH AE L OW IH NG
CRONK  K R AA NG K
DRAUGHTED	D R AO T IH D
BAYETE	B AY IY T
BACKINGS	B AE K IH NG Z
LEROUGE	L IY R UW ZH
ORNAVIT	AO R N EY V AH T
SYNDICATE  S IH N D IH K AH T
DUCHESNEAU  D AH SH IH S N OW
TIT'S	T IH T S
LAYERING  L EY ER IH NG
WODIN	W OW D IH N
BEAUTE	B Y UW T
VERRILL  V EH R IY L
DEMORALIZES	D IH M AO R AH L AY Z IH Z
FURNITURES	F ER N IH CH ER Z
CRAZES	K R EY Z IH Z
CANN  K AE N
ARROWY	EH R OW IY
THE'S	TH IY Z
SENDIN	S EH N D IH N
DESPENSERS	D EH S P EH N S ER Z
DOMINGO'S	D AH M IH NG G OW Z
SKELTER  S K EH L T ER
ALAS  AH L AE S
SARE  S EH R
HAMELY	HH AE M L IY
PEPUSCH	P EH P AH SH
AGGRESSION  AH G R EH SH AH N
JURAND'S	JH UH R AH N D Z
CHUCKIN	CH AH K IH N
PIERCER	P IH R S ER
GIELOW  JH IY L OW
DJEBEL	JH EH B AH L
TEASES  T IY Z IH Z
SILVERSTAR	S IH L V ER S T AA R
O'HEARN  OW HH ER N
OUTDISTANCED  AW T D IH S T AH N S T
DRYDEN'S	D R AY D AH N Z
DOWARD	D AW ER D
HOUMAN	HH UW M AH N
VENTVOEGEL	V EH N T V OW G AH L
INVINCIBILITY  IH N V IH N S AH B IH L IH T IY
ROHBAR	R OW B ER
CONGREGATION  K AA NG G R AH G EY SH AH N
BERTRIC	B ER T R IH K
BEAGLES  B IY G AH L Z
HERSCHELL  HH ER SH AH L
TUPPENNY	T AH P EH N IY
BIENTOT	B IY N T OW
REPAINTED  R IY P EY N T AH D
BION	B AY AH N
ACHAEMENIAN	AH CH IY M IY N IY AH N
INSURRECTIONS	IH N S ER EH K SH AH N Z
RESPECTS  R IH S P EH K T S
SAUVES	S AO V Z
ATABAPO	AA T AA B AA P OW
INGRATIATE  IH NG G R EY SH IY EY T
ALTUM	AE L T AH M
PANDANUS  P AE N D EY N AH S
PREBLE'S	P R EH B AH L Z
CRICKET'S  K R IH K AH T S
TRYETH	T R AY IH TH
KOUPRIANE	K UW P R IY AE N
UNATTACKABLE	AH N AH T AE K AH B AH L
CAJETAN	K AA Y EY T AH N
TREES  T R IY Z
TRESSITER	T R EH S IH T ER
LEGITIMIZE  L AH JH IH T AH M AY Z
BRILLIANT  B R IH L Y AH N T
MOODIE  M UW D IY
EMBARK'D	EH M B AA R K D
RUSTLIN	R AH S L IH N
HICKEY  HH IH K IY
SAUTRON	S AO T R AA N
UMBRIAN	AH M B R IY AH N
NAHARAINA	N AE HH ER EY N AH
OROSIUS	AO R OW S IY IH S
MANDAVACA	M AA N D AA V AA K AH
WORKSHOPS  W ER K SH AA P S
PROCUREUR	P R OW K Y UH R ER
HINKLE  HH IH NG K AH L
TET  T EH T
LUNES	L UW N Z
LONGIN	L OW NG G IH N
BAULK	B AO K
KIRKWOODS	K ER K W UH D Z
FORSLAND	F AO R S L AH N D
NUMERO	N UW M EH R OW
LIFFY	L IH F IY
CRICH	K R IH CH
DUSKA'S	D AH S K AH Z
RODOLPH'S	R OW D AA L F S
SCRIBED	S K R AY B D
COORDINATION  K OW AO R D AH N EY SH AH N
CUBIST  K Y UW B IH S T
LURKERS	L ER K ER Z
MASSEURS	M AE S ER Z
ARROGATED	EH R AH G EY T IH D
IRONWEED	AY ER N W IY D
DEMANDING  D IH M AE N D IH NG
DENSEST  D EH N S AH S T
PARTING  P AA R T IH NG
PHILOSOPHER'S	F AH L AA S AH F ER Z
VERBI	V ER B IY
BRATHWAITE	B R AE TH W EY T
THAPSUS	TH AE P S AH S
CAPPA  K AE P AH
CLARISSE  K L AE R IH S
PHRENOLOGISTS	F R IH N AA L AH JH IH S T S
SUNBLINDS	S AH N B L AY N D Z
JUVENAL	JH UW V AH N AH L
KENNEDYS  K EH N AH D IY Z
QUERIDA  K W EH R IY D AH
IBERI	IH B EH R IY
DORFIELD	D AO R F IY L D
AHAU	AH HH AA
HYLACTOR	HH IH L AE K T ER
FARVIE	F AA R V IY
HEAD  HH EH D
VICKSBURG  V IH K S B ER G
STUERMER	S T UW ER M ER
DUFOURNELLE	D AH F UH R N EH L
CENTIME  S EH N T AY M
SAVELL  S AA V EY L
LEA  L IY
TRESSAMER	T R EH S AH M ER
KANSA	K AE N Z AH
TURNOUTS  T ER N AW T S
COMPLEMENTARY  K AA M P L AH M EH N CH IY
VAWDREY'S	V AO D R EY Z
MARRINER  M EH R IH N ER
THUD  TH AH D
MORTAL'S	M AO R T AH L Z
NARBONNE	N AA R B AH N
PUDDLER	P AH D AH L ER
TOPPLETON	T AA P AH L T AH N
ELGIN  EH L JH IH N
SHOREHAM  SH AO R HH AE M
FLUCTUATE  F L AH K CH AH W EY T
FLACK  F L AE K
BACKYARD  B AE K Y AA R D
FARS	F AA R Z
BOABDIL	B OW AE B D AH L
THICKER  TH IH K ER
BEMISH	B EH M IH SH
TIDIER	T IH D IY ER
DISTENDING	D IH S T EH N D IH NG
PAYNHAM	P EY N HH AH M
JOVICA	JH OW V IH K AH
KINSTRY	K IH N S T R IY
STARSHIP  S T AA R SH IH P
BLACKLETTER	B L AE K L EH T ER
MA'LL	M L
O'FARNEL	OW F AA R N AH L
EXPERIMENTING  EH K S P EH R AH M EH N IH NG
OUTMODED  AW T M OW D AH D
STORMWAYS	S T AO R M W EY Z
REDDING'S	R EH D IH NG Z
CRUSOE  K R UW S OW
BLEND  B L EH N D
CORPANG	K AO R P AE NG
D'HIVER	D AY V ER
DVORAK'S	D V AO R AH K S
HEBER  HH IY B ER
REAPER  R IY P ER
MANNERS'S	M AE N ER Z IH Z
FELICITATING	F IH L IH S IH T EY T IH NG
SUPRACILIARY	S UW P R AH S IH L IY EH R IY
REPRESENTATIVES  R EH P R IH Z EH N T AH T IH V Z
CONTRIBUTION  K AA N T R AH B Y UW SH AH N
JIMPHY	JH IH M F IY
DUBREUIL  D AH B R UW L
GOOBER	G UW B ER
SACHE	S AA SH
PILSEN	P IH L S AH N
KATHELINE'S	K AE TH IH L AY N Z
MUGS  M AH G Z
OVERALL  OW V ER AO L
VENT'ROUS	V EH N T R AH S
LAPHAMS	L AE F AH M Z
RAZZLE  R AE Z AH L
DECKT	D EH K T
NOURVADY	N AO R V AA D IY
WITHEM  W IH TH IH M
RELATER	R IH L EY T ER
BEATITUDES	B IY T IH T UW D Z
POWDERED  P AW D ER D
THUND'RER	TH AH N D R ER
VERACRUZ	V EH R AA K R UW Z
PORPHYRY  P AO R F ER IY
TULRUMBLE	T AH L R AH M B AH L
ROSSITER'S	R AO S IH T ER Z
TIMEOUS	T AY M AH S
JACKA  JH AE K AH
ALTORF	AA L T ER F
IDALENE	IH D AH L IY N
HOTHAM	HH AA TH AH M
BASSIN  B AE S IH N
WILKESBARRE	W IH L K S B AA R
BONBON	B AA N B AH N
CROOKSHANK  K R UH K SH AE NG K
CONFECTIONERY  K AH N F EH K SH AH N EH R IY
SAEKKINGEN	S EH K IH NG AH N
OVERGREW	OW V ER G R UW
PAMELA  P AE M AH L AH
ROTHERWOOD	R AA TH ER W UH D
ENFRANCHISEMENT	IH N F R AE N CH AY Z M AH N T
TEVIL	T EH V AH L
ROUX  R UW
HURTED	HH ER T IH D
INGLESBY	IH NG G AH L S B IY
MINX	M IH NG K S
MUSQUETOON	M Y UW S K W EH T UW N
DRAGONFLIES	D R AE G AH N F L AY Z
ELANDS	IH L AE N D Z
SWIMMIN'	S W IH M IH N
NGATI	EH NG G AA T IY
SILAS  S AY L AH S
WALDORIA	W AO L D AO R IY AH
SHARON  SH EH R AH N
VERBAL  V ER B AH L
REPROACHABLE	R IY P R OW CH AH B AH L
CONTALMAISON	K AA N T AH L M EY Z AH N
RAABE  R AA B
BELYVE	B IH L AY V
SKARES	S K EH R Z
EBENEEZER'S	EH B AH N IY Z ER Z
YAVERLAND	Y EY V ER L AH N D
DEJAZET	D IY JH AH Z EH T
PAUVRES	P AA V Z
ZACCHAEUS	Z AE K EY AH S
GUERET	G EH R EY T
TAMALA	T AH M AA L AH
AILMENT  EY L M AH N T
OCAMPO  OW K AE M P OW
VIDA  V AY D AH
DEXTERITY  D EH K S T EH R AH T IY
TRUBNER	T R AH B N ER
FAUCES	F AO S AH Z
SOBERED  S OW B ER D
DAKER'S	D EY K ER Z
DEFENDANTS  D IH F EH N D AH N T S
PYNCHON	P IH N CH AH N
BARKS  B AA R K S
GWINNETT  G W IH N EH T
TREMONCEAU	T R EY M AA N S OW
LICKSPITTLE	L IH K S P IH T AH L
UNSHARED	AH N SH EH R D
ASCANIO	AE S K AE N IY OW
SHUCKING  SH AH K IH NG
VIOLENT  V AY AH L AH N T
METTA	M EH T AH
TOP'S	T AA P S
PENHALIGON	P EH N HH AH L IH G AH N
FORBES'S  F AO R B Z IH Z
HE'RT	HH IY R T
TELLEMENT	T EH L AH M AH N T
RIPPLE'S	R IH P AH L Z
DOMESTIC'S	D AH M EH S T IH K S
FORESTAL	F AO R AH S T AH L
VILLONA	V IY L OW N AH
LATCHKEY  L AE CH K IY
ESTEBAN'S	EH S T IH B AH N Z
CRUISING  K R UW Z IH NG
BRING  B R IH NG
APIECE  AH P IY S
CAPRICORNUS	K AE P R AH K AO R N AH S
COMPREHENDS  K AA M P R IY HH EH N D Z
MADELON'S	M AE D IH L AA N Z
GROSSWARDEIN	G R AA S W ER D AY N
BELABOURED	B IH L EY B ER D
THOROUGHBRACE	TH ER OW B R EY S
DISINTERESTEDLY	D IH S IH N T R IH S T IH D L IY
CAMERA'S  K AE M R AH Z
EXCESSIVE  IH K S EH S IH V
PHALANSTERY	F AH L AE N S T ER IY
PASTURAGE	P AE S CH ER AA ZH
CORFUAN	K AO F UW AH N
MARTEL'S	M AA R T EH L Z
HUGGER  HH AH G ER
HEXAGONAL  HH EH K S AE G AH N AH L
WHITLEY  W IH T L IY
CHAUMETTE	SH OW M EH T
TALENTED  T AE L AH N T AH D
LOCARNO	L OW K AA R N OW
AMEER'S	AH M IY R Z
ADIRONDACKS	AE D ER AA N D AE K S
DEPOSIT  D IH P AA Z AH T
AXIS  AE K S AH S
FERKOE	F ER K OW
POMADES	P OW M EY D Z
GORON	G AO R AA N
FLEMISTER'S	F L EH M IH S T ER Z
BICYCLISTS  B AY S IH K L IH S T S
RING'S  R IH NG Z
SCHEMER'S	S K IY M ER Z
TALLEYRANDS	T AE L EY R AH N D Z
COUNTERING  K AW N T ER IH NG
HEEAD	HH IY EH D
BODYE	B AA D IY
LISSAC	L IH S AH K
BOZRAH	B AA Z R AH
PROPHESYING	P R AA F AH S IY IH NG
HONDS	HH AA N D Z
PROTEST  P R AH T EH S T
FEARSOME  F IH R S AH M
SINIT	S IH N IH T
COE'S	K OW Z
METHODICAL  M AH TH AA D IH K AH L
METRUSTETH	M EH T R UW S T EH TH
SCRIBNERS  S K R IH B N ER Z
KUKULEYO	K UW K AH L EY OW
JALIS	JH AE L AH S
BULLECOURT	B UH L IH K AO R T
SPRIGS	S P R IH G Z
BIRGER	B ER JH ER
DELKOFF	D EH L K AO F
QUADRUPLING  K W AA D R UW P L IH NG
HUSTLE  HH AH S AH L
HAHA	HH AA HH AA
OBSESSIVE  AH B S EH S IH V
WAYES	W EY Z
BRAMSTON	B R AE M S T AH N
JOAN  JH OW N
DESDEMONA'S	D EH Z D IH M OW N AH Z
LADES	L EY D Z
HUMOROUS  HH Y UW M ER AH S
PIPPLE	P IH P AH L
SUPERSCRIPTION	S UW P ER S K R IH P SH AH N
ASSUAN	AH S W EY N
IRONMASTERS	AY R AH N M AE S T ER Z
CONSENSUAL  K AH N S EH N SH UW AH L
JOANNES	JH OW AE N Z
COLL'S	K AH L Z
LAMBERTI'S	L AA M B EH R T IY Z
MALA  M AA L AH
SANTAREM	S AA N T AA R EH M
RIGGED  R IH G D
CARDOZO  K AA R D OW Z OW
INTERJECT  IH N T ER JH EH K T
VERBIER	V ER B IY ER
LETTEH	L EH T AH
AURAMAZDA	AO R AH M AA Z D AH
REBRANDED	R IY B R AE N D IH D
DEALS  D IY L Z
SETCHEM	S EH T CH AH M
WEIGH  W EY
MARRIER	M EH R IY ER
DUNGAREE	D AH NG G ER IY
DEFENCED	D IH F EH N S T
SLANDERED  S L AE N D ER D
SEPTEMBER'S  S EH P T EH M B ER Z
L'ARTICLE	L AA R T AH K AH L
STAEMER	S T EY M ER
SYREN'S	S IH R AH N Z
PENGUIN'S	P EH NG G W AH N Z
VESTLESS	V EH S T L AH S
ELBA	EH L B AH
PRUDE  P R UW D
NOVASTOSHNAH	N OW V AE S T AH SH N AH
MAS'R	M AE S AH R
CAPI	K AA P IY
PLOWSHARES  P L AW SH EY R Z
EDGIN  EH JH IH N
DEFLUXION	D IH F L AH K SH AH N
NOBLEST  N OW B L IH S T
RAVELLO	R AH V EH L OW
ALBONI	AA L B OW N IY
PORE  P AO R
NOOT	N UW T
DURION	D UH R IY AH N
SCATTERED  S K AE T ER D
TEVIOTDALE	T EH V IY AH T D EY L
GUEPE	G EH P IY
DODHEAD	D AA D HH EH D
PACHALIK	P AH CH AA L IH K
GLIB  G L IH B
SQUIRREL'S	S K W ER AH L Z
ZENIE	Z IY N IY
BACKLOG  B AE K L AA G
IRRATIONAL  IH R AE SH AH N AH L
GAFFERTY	G AE F ER T IY
ARCHIVIST  AA R K AY V IH S T
PASTY	P EY S T IY
CORELLIA	K AO R EH L IY AH
WIFE'	W AY F
SLIGHTNESS	S L AY T N AH S
EBERT  EH B ER T
BAKIN	B AE K IH N
STONEMAN  S T OW N M AH N
DANITE	D AE N AH T
INDISPOSITION	IH N D IH S P AH Z IH SH AH N
BUZOT	B AH AA T
DEPRECIATIVE	D IH P R IY SH Y AH T IH V
OEDEMA	OW D EH M AH
GRANTER	G R AE N T ER
MANICHAEAN	M AE N AH CH IY AH N
FOR'RARD	F ER R ER D
RAUD	R AO D
MCMXXI	M AH K M K S IH
MAULBOY	M AO L B OY
SAXUM	S AE K S AH M
MACKAY  M AH K EY
WHAT  W AH T
SYOMARA	S AY OW M AA R AH
WHIMSICAL  W IH M Z IH K AH L
LUDOWIKA'S	L UW D OW IH K AH Z
STACKPOLE'S	S T AE K P OW L Z
FERRATA	F ER AA T AH
FORES	F AO R Z
HIPSLEY	HH IH P S L IY
ORSE	AO R S
BABA'S  B AA B AH Z
JULIEN'S	JH UW L IY AH N Z
ARYA	AA R IY AH
YELLOWLEES	Y EH L OW L IY Z
GANGANA	G AA NG G AA N AH
PARMENTER  P AA R M AH N T ER
PRAXILLA	P R AE K S IH L AH
MANTI	M AE N T IY
CEREMONIALS	S EH R AH M OW N IY AH L Z
BASHA  B AA SH AH
GOODFIELDS	G UH D F IY L D Z
D'OTRANTO	D ER T R AE N T OW
ENTOMOLOGISTS  EH N T AH M AA L AH JH AH S T S
SIMMIAS	S IH M IY AH Z
SPIDERWEB	S P AY D ER W EH B
ZEZOLLA	Z EY Z OW L AH
DESVANNEAUX	D EY V AA N OW
WOLDEN  W OW L D AH N
ROTONDO  R OW T OW N D OW
PANDOLPHUS	P AE N D AO L F AH S
HADEN'S	HH EY D AH N Z
SLITHERING  S L IH DH ER IH NG
LEAGUE  L IY G
SCURRILITY	S K ER IH L IH T IY
SUICIDED	S UW AH S AY D IH D
OGS	AA G Z
FIANCEES	F IY AE N S IY Z
NEURALGIA	N UH R AH L JH AH
MATCHING  M AE CH IH NG
J'AURAI	JH EY OW ER AY
STODDARD  S T AA D ER D
CASHELL	K AE SH AH L
COOTIES	K UW T IY Z
DEPECHES	D IH P EH SH AH Z
TOINEY'S	T OY N IY Z
ARVIE	AA R V IY
BARNABO	B AA R N AH B OW
FISHMAN  F IH SH M AE N
TURKLETAUB	T ER K AH L T AO B
TINAMOU	T IH N AH M UW
EFFECTS  IY F EH K T S
BRETIGNY	B R EH T IH N IY
MOTOZA	M OW T OW Z AH
COLTMAN	K OW L T M AH N
MANVANTARA	M AE N V AE N T AA R AH
BAUDRONS	B OW D R AH N Z
FIACHRA	F IY AA K R AH
DOGMATIC  D AO G M AE T IH K
MEETS  M IY T S
CASSIDY'S  K AE S IH D IY Z
DANA'S  D EY N AH Z
ANSTRUTHERS	AE N S T R AH DH ER Z
SWERVETH	S W ER V EH TH
LORING  L AO R IH NG
QUADROON	K W AA D R UW N
DISPUTER	D IH S P Y UW T ER
MARIETTA'S  M EH R IY EH T AH Z
PERI'S	P EH R IY Z
MEDALLION'S	M AH D AE L Y AH N Z
ORONTIDES	AO R AH N T AY D Z
PETROFF'S	P EH T R AO F S
GROOVED	G R UW V D
ENCIRCLING  EH N S ER K L IH NG
ARTISTICALLY  AA R T IH S T IH K L IY
POLYGAMOUS  P AH L IH G AH M AH S
CONSERVATORIUM	K AH N S ER V AH T AO R IY AH M
BALANCES  B AE L AH N S AH Z
BRIMBY	B R IH M B IY
SIMONS'S	S AY M AH N Z IH Z
QUINTUPLED  K W IH N T AH P AH L D
DERIVATION  D EH R AH V EY SH AH N
HOUSEDOOR	HH AW S D AO R
OVID'S	OW V IH D Z
BATAVIANS	B AH T EY V IY AH N Z
ABRAMS  EY B R AH M Z
WARDROP  W AO R D R AA P
APOLOGIZED  AH P AA L AH JH AY Z D
GOOG	G UW G
EARLESCOURT	ER L AH S K AO R T
KARASOWSKI	K AA R AH S AO F S K IY
CONSIGNMENTS	K AH N S AY N M AH N T S
DUFFHAM	D AH F HH AE M
REBIERA	R IY B IH R AH
HODUR	HH AA D ER
BESOTTED	B IH S AA T IH D
PREFERMENT	P R IH F ER M AH N T
SUPERFLUITIES	S UW P ER F L UW IH T IY Z
ANTIPATER	AE N T IH P AH T ER
VIVIEN'S	V IH V IY AH N Z
PRINTABLE  P R IH N T AH B AH L
BRYDGES  B R IH JH IH Z
FORTUNA  F AO R T UW N AH
DEEZE	D IY Z
ORRILO	AO R IY L OW
BACHMANN  B AA K M AH N
GOZZOLI	G AA Z OW L IY
DECENTER	D IH S EH N T ER
RECIPROCAL  R IH S IH P R AH K AH L
VALNY	V AE L N IY
NURNBERG	N ER N B ER G
PROCESSIONAL  P R AH S EH SH AH N AH L
GINNED  JH IH N D
CONSERVANCY  K AH N S ER V AH N S IY
CLUSTERED  K L AH S T ER D
RECALS	R IY K AE L Z
UMBRAM	AH M B R AH M
DISCLAIMS  D IH S K L EY M Z
QUABOS	K W AA B OW Z
RESPONDENT  R IH S P AA N D AH N T
BLACKMORE'S	B L AE K M AO R Z
UNREALIZABLE	AH N R IY AH L AY Z AH B AH L
TANKER  T AE NG K ER
WANNER  W AA N ER
RAYNER'S	R EY N ER Z
KASPAR'S	K AE S P ER Z
SYNECDOCHE	S IH N AH K D OW SH
SNUBS  S N AH B Z
GRAISSE	G R EY S
PUN  P AH N
FEUILLETON	F IY UW L T AH N
FORTY'S  F AO R T IY Z
TURMUT	T ER M AH T
ALLEYWAYS  AE L IY W EY Z
CENOTAPH	S IY N AH T AE F
HAJJI	HH AA Y IY
FRANTIC  F R AE N T IH K
HAKO	HH AA K OW
OTAKA	OW T AA K AH
GLYPTODON	G L IH P T AH D AO N
JOMAR	JH OW M AA R
UNTASTED	AH N T AE S T IH D
MERITORIOUS  M EH R AH T AO R IY AH S
GUSTUS  G AH S T AH S
ENORMOUSLY  IY N AO R M AH S L IY
BUSHWOMAN	B UH SH W UH M AH N
PONCHO  P AA N CH OW
JUDIE  JH AH D IY
BREDIN	B R EH D IH N
SCHALL  SH AO L
MOYE  M OY
SELECTED  S AH L EH K T AH D
GLUTTONY  G L AH T AH N IY
FLUID  F L UW AH D
BEAVERBROOK	B IY V ER B R UH K
REDEEMER	R IH D IY M ER
GROSCHUT	G R AO SH AH T
DISMEMBER  D IH S M EH M B ER
ABBAT	AH B AE T
CATSEYES	K AE T S AY Z
MAAR	M AA R
NOTHERN	N AH DH ER N
LEUTHEN	L OY TH AH N
BARBARE	B AA R B EH R
LAWFULNESS	L AO F AH L N AH S
MUSCOVITES  M AH S K AH V AY T S
WOOLPER	W UH L P ER
ARABI	AA R AA B IY
CASSIUS	K AE S IY AH S
ACK  AE K
EMERSON  EH M ER S AH N
PROSAIC  P R OW Z EY IH K
REBELS  R IH B EH L Z
IRREPROACHABLE	IH R AH P R OW CH AH B AH L
DIAN'S	D AY AH N Z
BATHGATE  B AE TH G EY T
CAUTERETS	K AO T ER IH T S
WARHAM'S	W AO R HH AE M Z
QUADRILLING	K W AA D R IH L IH NG
SOLVED  S AA L V D
CRAGGED	K R AE G D
RIENAECKER	R IY N EH K ER
HARMONICAS	HH AA R M AA N IH K AH Z
SECEDING  S IH S IY D IH NG
PARALYTICS	P EH R AH L IH T IH K S
HANDCOCK	HH AE N D K AA K
ATOCHA  AH T AA CH AH
BRUMAIRE	B R AH M EH R
FOSSOYEURS	F AA S OY ER Z
ELIAKIM	AH L AY AH K IY M
MULLINER'S	M AH L IH N ER Z
MOPPED  M AA P T
CONTI'S	K AA N T IY Z
WIGHTMAN  W AY T M AH N
MONDAIN	M AH N D EY N
LYTCHETT	L IH CH IH T
HETEROGENOUS	HH EH T ER AH JH AH N AH S
LEGGING  L EH G IH NG
MEAM	M IY M
LATREILLE	L AH T R AY L
SLOAN  S L OW N
ENRAGE  EH N R EY JH
CONROYAL	K AA N R OY AH L
PERSISTENCY	P ER S IH S T AH N S IY
VERRION	V EH R IY AH N
SNAGGED  S N AE G D
CANNELORO	K AE N AH L AO R OW
POCKETS  P AA K AH T S
CHAMILLY	CH AE M AH L IY
IS'	IH S
ORNANO	AO R N AA N OW
ARETINE	AA R EH T IY N IY
DONNEZ	D AA N EH Z
MOTIONING  M OW SH AH N IH NG
BAROUCHE'S	B AA R UW SH IH Z
SCRIBBLERS  S K R IH B L ER Z
HEARTH  HH AA R TH
BAPTIZING	B AE P T AY Z IH NG
D'ANNEBAUT	D AH N AH B AO T
SHIRR  SH ER
ACACIAS	AH K EY SH AH Z
VESTED  V EH S T IH D
DEVIN  D EH V IH N
BALU	B AH L UW
EARDRUM	IH R D R AH M
ABBES	AE B IY Z
JINX  JH IH NG K S
HAIMANOUT	HH EY M AH N AW T
GLATZ  G L AE T S
FEATHERTON	F EH DH ER T AH N
ALMANSOR	AA L M AA N S ER
BATELIER	B EY T L IY ER
OBERGATZ	OW B ER G AA T S
INNOCINT	IH N AH S IH N T
IMPERISHABLE	IH M P EH R IH SH AH B AH L
MORALIZES	M AO R AH L AY Z IH Z
PARLOW  P AA R L OW
IGNEOUS  IH G N IY AH S
ISAAC'S	AY Z IH K S
MIRTH  M ER TH
KRAGAN	K R EY G AH N
KATUTI'S	K AH T UW T IY Z
BONDSMEN	B AA N D Z M IH N
BLACKBIRDER	B L AE K B ER D ER
MOTTIN	M AA T IH N
RITUALISTIC  R IH CH UW AH L IH S T IH K
BANGBURY	B AE NG B EH R IY
HENNEBON	HH EH N IH B AO N
BERNERS	B ER N ER Z
SCHONTZ	SH AA N T S
